18岁以下不可以结婚。	18岁以下勿可以结婚。
21世纪社会，不懂电脑不懂外语往往会步步难行。	21世纪社会，勿懂电脑勿懂外语往往会步步难行。
3月30号的班机全部满座。	3月30号个班机全部客满。
8月份没课。	8月份呒没课。
A4纸到哪儿买？	A4纸头到啥地方买？
Ann在黑板上写了些什么。	Ann拉海黑板高头写了眼啥。
Ann是啦啦队队长。	Ann是啦啦队队长。
A够了，但是B不够。	A够了，但是B勿够。
Jack买不起新自行车。	Jack买勿起新脚踏车。
Jane在运动会之前把头发剃短了。	Jane拉垃运动会前头挪头发剃短了。
Jane正要离开家。	Jane正要离开屋里。
Jessie立刻接收了邀请。	Jessie立刻接收了邀请。
Kent生来就是个领导人。	Kent养出来就是个领导人。
Ken七月底要去美国了。	Ken七月底要去美国了。
Linux是一个免费的操作系统。你应该去试用一下。	Linux是一个免费个操作系统。侬应该去试用一下。
Steve看上去很高兴。	Steve看上去老高兴个。
Windows是世界上使用得最多的操作系统。	Windows是世界浪向使用了最多个操作系统。
一个丑男人敲了我的门。	一个难看个男人敲了我个门。
一个人藏，十个人找。	一个人囥，十个人寻。
一个人要为他的行为负责。	一个人要对伊个行为负责。
一个有名的建筑师造了这个房子。	一个有名个建筑师造了搿个房子。
一个真正的绅士不会出卖他的朋友。	一个真正个绅士勿会出卖伊个朋友。
一个长长个湖泊里，水多么清洁！	一只长长叫个湖泊水几化清爽！
一共是七千五百四十二元，你点一点。	一共拢总是七千五百四十二元，侬点一点。
一切都是为了你，所以不去！	为来为去侪为了侬咾勿去！
一到晚上，买几样蔬菜，看看电视，喝喝酒。	一到夜里，买两样熟菜，电视末看看，老酒末渳渳。
一只猫从篮子里出来了。	一只猫从篮头里向出来了。
一块圆桌玻璃被打碎了。	一块圆台玻璃敲碎脱了。
一块岩石从上面落下。	一块岩石从高头落下来。
一套红木家具要十几万钱呢！	一套红木家生要十几万洋钿拉海！
一年有十二个月。	一年有十二个号头。
一拨老年人，天天勿落下，弯腰昂头转身体。	一泼老头老太，天天勿脱班，弯腰昂头转身体。
一架客机出发飞往美国。	一架客机出发飞往美国。
一点也不便宜，贵得不得了。	一点勿便宜，贵得来熱昏。
一点也不累，谢谢先生来接我们。	一点也勿吃力，谢谢先生来接阿拉。
一碗绉纱馄饨，皮儿薄得连肉也看得见！	一碗绉纱馄饨，皮薄是薄得肉也看得见！
一种语言永远不够。	一种语言永远勿够。
一般我步行去学校。	一般我步行去学堂。
一边吃红茶咖啡，一边吃色拉西点，一边谈谈山海经。	一面吃吃红茶咖啡，一面吃吃色拉西点，一面谈谈山海经。
一逛马路，总要忍不住买点东西回去。	一荡马路，总归熬勿牢要买点物事回转去。
七点钟我打电话给你.	我七点钟打电话拨侬。
三个臭皮匠，赛过诸葛亮。	三个臭皮匠顶个诸葛亮。
三房二厅二卫，建筑面积是一百三十六平米，得房率百分之七十。	三房两厅两卫生，建筑面积一百三十六平方，得房率百分之七十。
上个月是十一月吗？	上个月是十一月，是𠲎？
上周她生了个漂亮的女孩。	上个礼拜伊生了个漂亮个女小人。
上海人结婚，有的人家办酒宴场面很大。	上海人结婚，有个人家酒水场面办得老大。
上海人要树立上海新形象。	上海人要树立上海新形象。
上海人讲上海话；上海人也都会讲普通话。	上海人讲上海话；上海人也侪会讲普通话。
上海夏天的最高温度要到三十八九度，真快热死了！	上海热天最高温度要到三十八九度，真是热煞快！
上海开埠以后，中西融合，兼收并蓄，形成了宽容、创新的海派文化。	上海开埠以后，中西融合，兼收并蓄，形成了宽容、创新个海派文化。
上海新好男人，又会拼命工作，又会将休闲进行到底。	上海新好男人，又会拼命工作，又会将休闲进行到底。
上海被称为东方的巴黎。	上海被称为东方个巴黎。
上海这个地方，海内海外什么菜肴都有。	上海搿块地方，海内海外样样小菜侪有。
下个礼拜除了星期一星期三有事，我其他日子都有空在那儿。	下个礼拜除脱礼拜一礼拜三有事体，我其他日脚侪有空拉海。
下午大概天转晴。	下半天大概天转晴。
下周我去温哥华看我妹妹。	下个礼拜我去温哥华看阿拉阿妹。
下次由我来开车。	下趟由我来开车。
下班时间还没，大家就想溜走。	下班辰光勿到末，大家就想滑脚。
不一样的，在浴池里洗澡，身体泡得彻底！	两样个，浴池里汏浴末，人泡得煞根！
不值得去两天。	勿值得去两天个。
不坐了，我还有点事儿呢。	勿坐了，我还有点事体拉海。
不是所有的小孩子都喜欢苹果。	勿是所有小人侪欢喜苹果个。
不是的，他是我们的业务主管。	勿是个，伊是阿拉个业务主管。
不是瞎说，我这份工作真是没劲！	勿是瞎讲，我搿份工作真叫呒没劲！
不答应，我从来没有答应过。	勿答应，我从来呒没答应过。
不管你怎么做，结果都一样。	勿管侬哪能做，结果侪一样。
不管我去哪儿，我都不会忘记您的好。	勿管我去阿里搭，我侪勿会忘记脱侬个好。
不能去乱碰的！	勿好去瞎碰个！
不行，我不能做赔本生意。	勿来三个，我勿好做折本生意个。
不要变胖。	勿要变胖。
不要和任何人说我们的计划。	勿要跟任何人讲阿拉个计划。
不要开门。	勿要开门。
不要往我房间里看。	勿要往我房间里向看。
不要甩门。	勿要甩门。
不要相信一个你一点都不了解他过去的人。	勿要相信一个侬一点也勿了解伊过去个人。
不要边走边看书。	勿要边走边看书。
不谈了！我们去周庄玩怎么样？	勿谈了！阿拉到周庄去白相好𠲎？
不跟你讲话了！	勿跟侬讲言话了！
不过也有些地方不值得去。	不过也有点地方呒没啥去头。
不过，外语、电脑对多数人来讲，毕竟还只是一个常用工具。	不过，外语、电脑对多数人来讲，到底还是一个常用工具。
不过现在家家人家都有浴缸，洗个澡不是挺方便的吗？	不过现在家家屋里侪有得浴缸，汏汏浴勿是蛮便当个吗？
世上最好的小提琴是用雷击木造成的。	世界浪最好个小提琴是用雷击木造成功个。
两个，我们住标准房吧，多少钱一个晚上？	两个，阿拉住标房好了，几钿一夜？
两年前我在这个学校注册了。	两年前我垃海搿个学堂注册了。
严重吗？	严重𠲎？
临时抱佛脚。	临时上轿穿耳眼。
为了自己的健康，他戒了烟。	为了自家个健康，伊挪香烟戒脱了。
为什么不听我的话？	为啥勿听我个言话？
为什么不问问你老师的建议呢？	为啥勿问问㑚老师个建议呢？
为什么？	为啥?
为什么你不学法语？	为啥侬勿学法语？
为什么你企图逃走？	为啥侬准备逃了跑？
为什么你想到外国读书？	为啥侬想到外国读书？
为什么喜欢喝浓咖啡？	啥道理欢喜吃浓咖啡？
为什么您想到外国读书？	为啥侬想到外国读书？
为什么您试着逃走？	为啥侬试了逃了跑？
为什么这两天一天比一天热？	为啥搿两日一日比一日热？
为啥不早点讲！	啥体勿早点讲！
乘船过海非常舒服。	乘船过海邪气舒宜。
也许昨晚下了一场雨。	昨日夜到讲勿定落了一场雨。
书架上都是书。	书架高头侪是书。
书桌上一叠专业书里有几本卡通书混在里面。	写字台高头一叠专业书里混拉海几本卡通书。
书桌上有几本书。	写字台高头有几本书。
买火车预定票的窗口在哪里？	买火车预定票个窗口垃拉阿里？
事故耽误了我们半小时。	事故耽误了阿拉半个钟头。
二十二岁的人还会学习关于自己的语言的东西是不可设想的事。	廿二岁个人还会得学习关于自家语言个物事是勿可能设想个事体。
二月十二号。你什么时候生的？	二月十二号。侬几时生个啊？
五十岁以后学一门新的语言不是那么容易。	五十岁以后学一门新个语言勿是介容易。
京都有很多所大学。	京都有老许多所大学。
人们也出来逛啊逛的，东转西溜，挤来挤去，走着玩儿。	人也出来荡发荡发，七兜八兜，轧来轧去，走走白相相。
人应该明白世界在变。	人应该明白世界垃海变。
什么时候开始下雨的?	啥辰光开始落雨个?
什么时候开始？	啥个辰光开始？
什么时候开门？	啥个辰光开门？
今天上午就可以送到，快递费收10元钱。	今朝上半天就可以送到，快递费收10元洋钿。
今天下午我有两个小时的英语课和两个小时的汉语课。	今朝下半天我有两个钟头个英语课跟两个钟头个汉语课。
今天傍晚请你帮我把这些DVD碟片带回去。	今朝夜快头请侬帮我拿搿点DVD碟片带回去。
今天刮冷风。	今朝刮冷风。
今天即使再忙，也要做完这些事情才走。	今朝忙做忙，也要做光搿点生活再走。
今天夜晚去广州的火车票还有吗？	今朝夜到去广州个火车票还有𠲎？
今天很抱歉，让你等了这么多时间。	今朝老抱歉个，叫侬等了介许多辰光。
今天我们一家大小都去叔叔家玩好吗？	今朝阿拉一家门侪到爷叔搭去白相好𠲎？
今天我们来揭开英文虚拟式的神秘面纱。	今朝阿拉来揭开英文虚拟式个神秘面纱。
今天我头痛欲裂。	今朝我头痛得要裂开来了。
今天我来请客。	今朝我来请客。
今天我要去买些材料。	今朝我要去买眼材料。
今天既然到了城隍庙，就要尝尝本地小吃的味道了。	今朝到城隍庙了末，就要尝尝本邦小吃个味道了。
今天是我请客。	今朝是我请客。
今天晚上你在什么地方有约会？	今朝夜到头侬约会约拉啥地方？
今天穿了这件有点儿红的衬衫，我能走出去吗？	今朝穿了搿件红兮兮个衬衫，我跑得出去𠲎？
今天糟糕透了，所以我准备去喝一杯就直接上床。	今朝糟糕透了，所以我准备去喝一杯就直接上床。
今天这点东西大减价，任凭你挑吧。	今朝搿眼物事大减价，侬听拣好唻。
今晚你打算做什麽？	今朝夜里侬打算做啥？
今晚我将在朋友家过夜。	今朝夜到我会得垃海朋友屋里过夜。
今晚谁要打扫？	今朝夜到啥人要打扫？
从来就没有徒劳的爱情。	从来就呒没白白里个爱情。
从松江、青浦一带的出土文物中看到，上海西郊有六千多年历史。	从松江、青浦一带个出土文物当中看到，上海西郊有六千多年历史。
他7点到了火车站。	伊7点钟到了火车站。
他一直很担心他的女儿。	伊一直老担心伊拉囡儿个。
他上学总是迟到。	伊读书老是迟到。
他上身长得呈倒三角形，站在那里看上去特帅！	伊长个是三角身胚，立拉海看上去瞎帅！
他不会违背他的原则。	伊勿会得违背伊个原则。
他不惜用私人时间来工作。	伊勿惜用私人辰光来工作。
他不打算买一个摄像机。	伊勿打算买一部摄像机。
他不知羞耻地说他绝不会跟一个飞机场谈恋爱。	伊勿要面孔个讲伊从来勿会得跟个砧吨板轧朋友。
他也是推销员。	伊也是推销员。
他买土地目的是要造房子。	伊买土地目的是要造房子。
他今天要熏鲭鱼。	伊今朝要熏鲭鱼。
他从什么地方来的？	伊啥地方来个？
他从早到晚只是在抱怨。	伊从早到夜只是垃海抱怨。
他从热那亚来。	伊从热那亚来个。
他从英国来。	伊从英国来个。
他们上午来坐了一下，说下午就要离开上海。	伊拉上半日来坐了坐，讲下半日就要离开上海。
他们两位现在太忙了，不想跟你谈。	伊拉两位现在忙勿过，勿想帮侬谈。
他们，切红肠啦，拌色拉啦，煮罗宋汤啦，自己做西菜。	伊拉是红肠切切，色拉拌拌，烧烧罗宋汤，自家做西菜。
他们匆匆忙忙去看足球赛，屋里头东西都丢在那儿。	伊拉匆匆忙忙去看足球赛，屋里物事侪摊拉海。
他们午饭吃了三明治。	伊拉中饭吃了三明治。
他们变得很紧张。	伊拉变得老紧张个。
他们在加利福尼亚种橙子。	伊拉垃海加利福尼亚种橙子。
他们在画展上授予了她一等奖。	伊拉垃海画展高头授予了伊一等奖。
他们坚持让他走。	伊拉坚持让伊走。
他们布置了一个暖房。	伊拉布置了一个暖房。
他们带来了一包糅粉和一包青元子。	伊垃带了一包糅粉搭一包青糰子来。
他们是热爱和平的人。	伊拉是热爱和平个人。
他们有了很多孩子。	伊拉有了交关小人。
他们有他们自己的文化。	伊拉有伊拉自家个文化。
他们正在焚书。	伊拉垃海焚书。
他们沿着非洲西岸航行了。	伊垃沿牢非洲个西岸航海了。
他们生活得很幸福。	伊拉生活了老幸福个。
他们的合同在这个月底到期。	伊拉个合同垃海搿个月底到期。
他们的旅行因为下雨延期了。	伊拉个旅行因为落雨延期了。
他们的旅行因为下雨延期了。	伊拉个旅行因为落雨达闲了。
他们的旅行因为火车延期了。	伊拉个旅行因为火车延期了。
他们的旗五颜六色。	伊垃面旗帜红颜绿色个。
他们粗心大意，还没意识到危险。	伊拉粗心大意，还呒没意识到危险。
他们说她是在德国出生的。	伊拉讲伊是垃海德国出生个。
他们运气好得飞上天了。	伊垃额骨头碰着天花板。
他们都是好老师。	伊拉侪是好老师。
他会弹钢琴。	伊会得弹钢琴个。
他会说十种语言。	伊会得讲十种语言。
他会说法语吗？	伊会得讲法语𠲎？
他伸长了他的右手。	伊伸长了伊个右手。
他俩的爱情，已经上升了一个台阶。	伊拉两家头个爱情，已经升了一个台阶。
他做的事情你赞成的吧？	伊做个事体侬赞成个𠲎？
他写阿拉伯文。	伊写阿拉伯文。
他出国留学了。	伊出国留学了。
他出席了会议。	伊出席了会议。
他刚离开家。	伊刚离开屋里。
他割掉了树上的几根树枝。	伊拿树浪向几根树枝割脱了。
他半夜打电话给我。	伊半夜里打电话拨我。
他去买了两回也没买到。	伊去买了两趟呒没买到。
他去美国学医了。	伊去美国学医了。
他又是矮矮的，又是胖得肉也鼓出来。	伊末，又是矮墩墩，又是壮得肉也绽出来。
他发誓要戒烟。	伊发誓要戒烟。
他受邀做俱乐部的主席。	伊受邀请做俱乐部个主席。
他叫了一盘炒什锦。	伊叫了盆炒什锦。
他可能永远不成名。	伊可能永远勿成名。
他后悔在校时没用功读书。	伊后悔垃海学堂个辰光呒没用功读书。
他向权力屈服。	伊向权力屈服。
他喜欢旅行. 我也是.	伊欢喜旅游。我也是个。
他喜欢比较浅的绿色。	伊欢喜比较淡眼个绿颜色。
他在打扫他的房间。	伊垃海打扫伊个房间。
他在气头上，说了所有他想说的话就回家了。	伊垃海气头浪向，讲了所有伊想讲个言话就回去了。
他在澳大利亚长大。	伊垃海澳大利亚长大个。
他在这个城市有一些朋友。	伊垃拉搿个城市有一眼朋友。
他在银行工作。	伊垃海银行工作。
他坐在两张椅子上。	伊坐垃两只矮凳高头。
他失去了最爱的儿子。	伊失去了最爱个儿子。
他好像对音乐剧什么的很感兴趣，而且还非常内行。	伊好像对音乐剧咾啥老感兴趣，外加还邪气懂经。
他好像对音乐剧什么的很感兴趣，而且还非常内行。	伊好像对音乐剧咾啥老感兴趣，而且还邪气懂经。
他学会了游泳。	伊学会了游泳。
他实足二十五岁。	伊实足廿五岁。
他平常注意锻炼，所以胸肌腹肌都是非常硬的！	伊平常注意锻炼咾，胸肌腹肌侪是邦邦硬个！
他当时一个人在家。	伊当时一个人垃海屋里。
他很可能赢得比赛。	伊老可能赢得比赛个。
他很喜欢旅游。	伊邪气欢喜旅游。
他很少来看我。	伊老少来看我。
他很年轻，更重要的是，他很帅。	伊老年轻个，更加重要个是，伊老帅个。
他很快便与小区里新来的男孩交上了朋友。	伊老快就跟小区里新来个男小囡交上了朋友。
他很难写他的名字。	伊老难写伊个名字个。
他得了个外快赚到钱了。	伊额快一机得着票子了。
他怕坐飞机。	伊怕坐飞机。
他总是很忙。	伊一直老忙个。
他把不动产留给了他的孩子。	伊拿勿动产留拨了伊个小人。
他把东西留给了他的儿子。	伊拿物事留拨了伊拉儿子。
他把他的旅行推迟到明天了。	伊拿伊个旅行推迟到明朝了。
他把他的自行车刷成红色。	伊挪伊个脚踏车刷成红颜色。
他把他的财产留给了他儿子。	伊拿伊个财产留拨了伊拉儿子。
他把头发剪短了。	伊挪头发剪短了。
他把座位让给了一个老人，这显示出他很有礼貌。	伊拿座位让拨了一个老人，搿显示出伊老有礼貌个。
他把所有他借来的钱还了。	伊挪所有伊借的来个钞票还脱了。
他把手插进了口袋。	伊挪手插进了口袋。
他把自己的钱包掉到地上，现在是我的了。	伊拿自家个皮夹子落了地浪向，现在是我个了。
他把财产留给了他的儿子。	伊拿伊个财产传拨了伊拉儿子。
他拒绝跟我握手。	伊拒绝跟我採手。
他接受了他的失败。	伊接受了伊个失败。
他放我鸽子；我等了他一整晚！	伊放我白鸽；我等伊一夜天了！
他无论到哪儿都很受欢迎。	伊勿管到阿里搭侪老受欢迎个。
他昨天看了一部最有趣的小说。	伊昨日看了一部最有意思个小说。
他是个好人。	伊是个好人。
他是为这个原因离开了学校。	伊是为了搿个原因离开了学堂。
他是哈佛大学的生物学教授。	伊是哈佛大学个生物学教授。
他是我太太认识的一个人。	伊是阿拉太太认得个一个人。
他是法国人。	伊是法国人。
他是美国人。	伊是美国人。
他是营销部的负责人。	伊是营销部个负责人。
他有一个兄弟和两个姐妹。	伊有一个兄弟跟两个姐妹。
他有一辆威驰。	伊有一部威驰。
他有两只猫。	伊有两只猫。
他有可能赢得比赛。	伊有可能赢得比赛。
他有很多历史书籍。	伊有交关历史书籍。
他有很多钱。	伊有交关钞票。
他有很多钱。	伊有得老多钞票。
他有麻烦。	伊有麻烦。
他来自杭州。	伊从杭州来个。
他来这里已经过了一年了。	伊来搿搭已经过了一年了。
他正在做功课。	伊垃海做功课。
他正坐在会议室里。	伊正坐拉会议室里向。
他每天去学校学习。	伊每日天到学堂里去读书。
他没立遗嘱就死了。	伊呒没立遗嘱就死脱了。
他洗车。	伊汰车。
他父母对他期望过高。	伊拉爷娘对伊期望过高。
他登上了前往洛杉矶的飞机。	伊登上了前往洛杉矶个飞机。
他的兴趣爱好是收集旧邮票。	伊个兴趣爱好是收集旧邮票。
他的努力没有成果。	伊个努力呒没成果。
他的化学很差。	伊个化学老差个。
他的医生命令他休息。	伊个医生命令伊休息。
他的医生建议他戒烟。	伊个医生建议伊戒烟。
他的忠告总是很明智。	伊个忠告一直是老明智个。
他的数学比我好。	伊个数学比我好。
他的死对我们公司是一个巨大的损失。	伊个过世对阿拉公司是一个巨大个损失。
他的秘书好像了解真相。	伊个编书好像了解真相个。
他的继母很凶恶。	伊个后娘老恶劣个。
他的继母很凶恶。	伊个继母啦老恶劣个。
他的车在加油站洗过了。	伊个车子垃海加油站汰过了。
他睡着的时候，打呼声很响。	伊困着个辰光，打呼声音老响个。
他确实很穷，但是他很幸福。	伊确实老穷个，但是伊老幸福个。
他离开东京，去了大阪。	伊离开东京，去了大阪。
他竟然还给我装傻。	惹伊还脱我装戆唻。
他给他的母亲写信。	伊帮伊拉姆妈写信。
他给我们讲了一个有趣的故事，我们都笑了起来。	伊帮阿拉讲了一个有趣个故事，阿拉侪笑起来了。
他给我的工作作出了明确指示。	伊帮我个工作作出了明确指示。
他老要摆架子。	伊老要搭架子个。
他老要摆架子。	伊老要摆标金个。
他考GRE、TOEFL，你到底知道吗？	伊考寄托侬晓得勿啦？
他被选为市长。	伊被选为市长。
他要上进了。	伊垃拉要上进了。
他要钱。	伊要钞票。
他认识很多人。	伊认得交关人。
他说他饿了。	伊讲伊饿了。
他说得好像知道这个秘密一样。	伊讲得来好像晓得搿个秘密一样个。
他说得很大声。	伊讲了老大声个。
他说过他不会进来，但他最后还是进来了。	伊讲过伊勿会进来，但伊最后还是进来了。
他还会说俄语。	伊还会得讲俄语。
他还没来。他肯定错过公交车了。	伊还呒没来。伊肯定错过公交车了。
他这个时候该到了。	伊搿个辰光该到了。
他进来的同时，铃响了。	伊进来个同时，铃响了。
他迟早会回来的。	伊早晏点会回来个。
他送给我一份漂亮的礼物。	伊送拨我一份漂亮个礼物。
他长大了会成为一名医生。	伊长大了会成为一名医生。
他问我买了什么。	伊问我买了啥。
以前苏州河被污染得又黑又臭，你可以看看前几年照的相片。	以前苏州河污染得又黑又臭，侬可以看看前几年拍个照片。
价钱可以打折吗？	价钿好打折头𠲎？
任何时间我都可以。	随便啥个辰光我侪可以个。
休息天你看电视以外，还喜欢去什么地方转转？	休息日脚侬看电视以外，还欢喜啥地方去转转？
休闲要休得过瘾，休出情调品味高水平。	休闲要休了扎劲，休出情调品味高水平。
会议室正在使用中。	会议室正垃海使用当中。
但你喜欢！	但侬欢喜呀！
但我有能力烧得好菜。	但我有能力烧得好菜。
但是现在城区大多数地方，在唐朝以前还是海滩或者海。	但是现在城区大多数地方，拉唐朝以前还是海滩或者海。
你一旦开始了，就应该继续下去。	侬一旦开始了，就应该继续下去。
你一用完了这本书，就把它放回原来找到的地方。	侬用好搿本书个辰光，拿伊放回到原来寻到个地方。
你一般几点下班？	侬一般几点钟下班？
你一路往前走，过了红绿灯就到了。	侬一埭路里朝前走，过了红绿灯就到了。
你三房子得房率高不高？面积大不大？	侬个房子得房率高勿高？面积大勿大？
你不关心，所以不知道。	侬勿关心咾勿晓得。
你不应该在学校大楼里奔跑。	侬勿应该垃海学堂大楼里跑。
你不渴吗？	侬嘴巴勿干吗？
你不知道上海有各种各样的“吧”，你又傻帽了！	侬勿晓得上海有各式各样个“吧”，侬又戆脱唻！
你不能把你的车停在这里。	侬勿能挪侬个车子停拉搿搭。
你不要装聋作哑！	侬勿要垃拉假痴假呆！
你不该做这样一件事情。	侬勿该做搿能一桩事体。
你不这么认为吗？	侬勿搿能认为吗？
你为什么不相信我？	侬为啥勿相信我？
你为什么指责我儿子？	侬为啥指责我儿子？
你为什么生气？	侬为啥发脾气？
你为什么生气？	侬作啥生气？
你为什么要骂人家？	侬啥事体要骂人家？
你为什么跟他生气？	侬为啥跟伊发脾气？
你乘飞机还是乘火车去？	侬乘飞机还是乘火车去？
你也太会做买卖了啊。	侬也太会做买卖了呀。
你什么时候从米兰回来？	侬啥辰光从米兰回来？
你什么都没看见。	侬啥也呒没看见。
你今天下去锻炼了吗？	侬今朝下去锻炼过𠲎？
你今天忙吗？	侬今朝忙𠲎？
你从这里过去到那里，穿过第二条横马路就是。	侬从搿搭过去到哀面，穿过第二条横马路就是。
你们周日送货吗？	㑚礼拜天送货𠲎？
你们对外语感兴趣吗？	㑚对外语感兴趣𠲎？
你们怎么会认识的？	㑚哪能认得个？
你们昨天为什么离开教室？	㑚昨日为啥离开教室？
你们看，他们书房里倒收拾得很清洁哪。	㑚看，伊拉书房里倒收作得清清爽爽拉海。
你们看，窗开着，厨房门也没关！	㑚看，窗开垃拉，厨房间门也呒没关！
你们约好在什么时间碰头？	㑚约好拉啥辰光碰头个？
你们自己吃蛋糕。	㑚自家吃蛋糕。
你们谈了什么？	㑚讲了点啥？
你们这儿生意最好，这么热闹！	㑚搿搭生意顶好，介闹猛！
你们那儿什么菜最有特色。	㑚搿搭啥个菜最有特色
你们非常勇敢。	㑚非常勇敢。
你会代替我去派对吗？	侬会得代替我去派对𠲎？
你会发现难以满足她。	侬会发现老难满足伊个。
你会打网球吗？	侬会得打网球伐？
你会溜冰吗？	侬会得溜冰𠲎？
你会讲普通话吗？	侬普通话讲得来𠲎？
你会说上海话吗？	侬上海言话讲得来𠲎？
你其实没必要带伞。	侬其实呒没必要带伞。
你准备从哪个地方出境？	侬准备从啥个地方出境？
你准备待多久？	侬准备登多长辰光？
你几点出发？	侬几点钟出发？
你别胡说！	侬勿要瞎讲！
你到厨房里替我把一把锤子拿来。	侬到厨房间里一把榔头脱我拿拿来。
你到底答应吗？	侬答应口勿啦？
你到这儿拐弯角上去坐地铁。	侬到搿搭转弯角子浪去乘地铁。
你去叫他来。	侬去叫伊来。
你去看过医生了吗？	侬去看过医生了𠲎？
你叔叔让你开他的车了吗？	㑚爷叔让侬开伊个车了𠲎？
你只是做了你的功课。	侬只勿过是做了侬个功课。
你只要在这里写下你的姓名和地址就行了。	侬只要拉海搿搭挪侬个姓名跟地址写下来就来塞了。
你可以买你喜欢的那个，而不是两个都买。	侬可以买侬欢喜个哀个，而勿是两个侪买。
你可以到有“银联”标志的ATM机里去取钱。	侬可以到有“银联”标志个ATM机里去拿钞票。
你可以在这里学习。	侬可以垃海搿搭学习。
你可以想象在月球上行走吗？	侬可以想象垃海月球高头行走𠲎？
你可以给我一点奶油五香豆。	侬可以拨我一点奶油五香豆。
你可以读你喜欢的书。	侬可以读侬欢喜个书。
你可以骑上我的摩托车去遛一圈。	侬可以骑上我个摩托车去遛一圈。
你可能是对的，但我和你意见相反。	侬可能是对个，但是我跟侬意见相反。
你吃过生鱼片吗？	侬生鱼片吃过歇𠲎？
你吃面条还是吃饭？喝橙汁还是喝咖啡？	侬吃面条还是吃饭？橙汁还是咖啡？
你吃饭了吗？	侬饭吃过了𠲎？
你吸烟吗？	侬香烟吃勿吃个？
你喜不喜欢日本菜？	侬欢勿欢喜日本菜？
你喜欢做什么？	侬欢喜做啥？
你喜欢唱歌吗？	侬欢喜唱歌𠲎？
你喜欢音乐吗？	侬欢喜音乐𠲎？
你回家乡去住多少天？	侬回到家乡去住几化日脚？
你在一个安全的地方。	侬垃海一个安全个地方。
你在听我说吗？	侬垃海听我讲𠲎？
你在笑我还是怎样？我跟你说了三次不要说话好好听课。	侬垃海笑我还是哪能？我脱侬讲了三趟勿要讲闲话好好听课。
你声音大一点，我听不出来！	侬声音大一点，我听勿出！
你好。您想要什么吃的吗？	侬好。侬想要啥个吃个𠲎？
你如果高兴，就吃一点吧。	侬如果高兴，就吃一点𠲎。
你学英语吗？	侬学英语𠲎？
你安全到达目的地以后，别忘记打个电话告诉我。	侬安全到达目的地以后，勿要忘记打只电话告诉我。
你对什么都太怀疑了。	侬对啥侪太怀疑了。
你对女人有一套。	侬对女人有一套。
你差不多猜对了。	侬差勿多猜对了。
你已经没用了。	侬已经呒没用了。
你帮我把这两封信寄掉好吗？	搿两封信侬帮我寄寄脱好𠲎？
你应该一直让手保持干净。	侬应该一直让手保持干净。
你应该为你的粗鲁向她道歉。	侬应该为侬个粗鲁向伊道歉。
你应该小心不要着凉。	侬应该当心勿要冷着。
你应该跳个槽，我介绍你到我连襟的公司去做他的搭档。	侬应该跳跳槽，我介绍侬到阿拉连襟个公司去做伊搭子。
你很快就会习惯吃日本料理了。	侬老快就会习惯吃日本料理了。
你很快就会喜欢上这个城市。	侬老快就会欢喜上搿个城市。
你很快就会适应你的新学校。	侬老快就会适应侬个新学堂。
你得在涉谷换乘火车。	侬要垃海涉谷换乘火车。
你必须在天黑前回来。	侬必须垃海天黑以前回来。
你必须弥补损失。	侬必须弥补损失。
你忙吗？	侬忙𠲎？
你怎么一有空就上网，冲浪灌水打QQ，一个夜晚就扔给它了？	侬哪能一有空就上网，冲浪灌水打QQ，一个夜头就掼拨伊了？
你怎么这么慢！	侬哪能介慢个啦！
你怎么这么要紧哪！	侬哪能搿能要紧啦！
你怎么连动也不动？	侬哪能动也勿动？
你总是在唱歌。	侬一直垃海唱歌。
你想再来杯酒吗？	侬想再来杯酒𠲎？
“你想再来点咖啡吗？”“不，谢谢。我够了。”	“侬想再来眼咖啡𠲎？”“勿要了，谢谢，我够了。”
你想喝茶还是喝咖啡？	侬要吃茶还是吃咖啡啊？
你想成为什么？	侬想成为啥？
你想找哪个方面的工作？	侬想找阿里方面个工作？
你想清楚，大概在什么时间什么地方掉的？	侬想想清爽，大概拉啥辰光啥地方落脱个？
你想要杯果汁吗？	侬想要杯果汁𠲎？
你打算出国吗？	侬打算出国𠲎？
你把文章看了没？	侬搿篇文章看过了伐？
你把窗门开开，把空调关了！	侬窗门开一开，拿空调关脱伊！
你把衣服晾出来！	侬衣裳㫰出来！
你把门开着真是太不小心了。	侬拿门开垃海真是忒勿小心了。
你数学好吗？	侬数学好𠲎？
你明早7点来接我吗？	侬明朝早浪向7点钟来接我𠲎？
你昨天打网球了吗？	侬昨日打网球了𠲎？
你昨天早上在打网球吗？	侬昨日早浪向垃海打网球𠲎？
你是个厕所！	侬是个马桶间！
你是从哪个国家来的？	侬是从阿里个国家来个？
你是公派出去，还是因私出国？	侬是公派出去，还是因私出国？
你是大学生吗？	侬是大学生𠲎？
你更喜欢哪个，这个还是那个？	侬更加欢喜阿里个，搿个还是哀个？
你最喜欢哪一个绕口令？	侬最欢喜啊里个绕口令？
你最好不要和他来往。	侬最好勿跟伊来往。
你最好去一下医务室。	侬最好去一下医务室。
你最好快点。	侬最好快点。
你最好打消这么可笑的念头。	侬最好打消介可笑个念头。
你最好请教一下医生。	侬最好请教一下医生。
你有义务还债。	侬有义务还债。
你有什么冰冻饮料？	侬有啥个冰冻饮料？
你有今天的票吗？	侬有得今朝个票子伐？
你有你的爱好，我有我的兴趣，不管你甚事！	侬有侬个爱好，我有我个兴趣，关侬啥事体！
你有没有收据？	侬收据有勿有？
你来上海多少时间了？	侬到上海几化辰光了？
你来点菜吧。	侬来点菜好唻。
你每次都继续犯同样的错误。	侬每趟侪继续犯同样个错误。
你没有一点钱吗？	侬一点钞票也呒没吗？
你浸湿了。	侬人淌淌底。
你猜得出这个迷语吗？	侬猜得出搿只灯迷伐？
你玩什么运动吗？	侬白相啥个运动𠲎？
你现在在做什么？	侬现在垃拉做啥？
你现在好点了吗？	侬现在好点了𠲎？
你现在想要什么？	侬现在想要啥？
你理发要长一点还是短一点？	侬剃头发要剃得长点还是短点？
你生日的时候，我送你一辆自行车。	侬生日个辰光，我送侬一部脚踏车。
你疯了吗？	侬疯脱了伐？
你的妈妈会开车吗？	㑚姆妈会得开车𠲎？
你的差使换给我做干就好了。	侬个差使调拨我做做就好了。
你的手表比我的贵。	侬个手表比我个贵。
你的测验怎么样？	侬个测验哪能？
你的灵魂已经坠进地狱了。	侬个魂灵头已经坠进地狱了。
你的笔比我的好。	侬个笔比我个好。
你的答案是错的。	侬个答案是错个。
你的结论具有高度争议性。	侬个结论具有高度争议性。
你的背包在我办公桌上面。	侬个背包拉垃我个办公桌高头。
你的行为不得体。	侬个行为勿得体。
你的袜子上有个大洞。	侬个袜子高头有个大洞。
你的裙子不适合这种场合。	侬个裙子勿适合搿种场合。
你相信上帝吗？	侬相信上帝𠲎？
你看买点什么东西给他吃？	侬看买点啥个物事拨伊吃吃？
你看他傻乎乎的模样，倒也挺可爱。	侬看伊戆头戆脑个样子，倒也蛮可爱。
你看，桌子上还放了一叠校样。	侬看，台子高头还摆了一叠校样。
你看这两张照片哪张好？	侬看两张照片里阿里张好？
你看这两种哪一种好？	侬看搿个两样当中阿里一样好？
你看这张表吧，上面已经写清楚了。	侬看搿张表好唻，高头已经写清爽了。
你看，马路上人多极了，人挤人，大家凑热闹。	侬看，马路高头人瞎多，人轧人，大家轧闹猛。
你真是那么好吗？	侬真介好唻？
你睡得好吗？	侬困得好𠲎？
你知道这件事吗？	搿桩事体侬晓得𠲎？
你知道音乐家什么时候来这儿吗？	侬晓得音乐家啥个辰光来搿搭𠲎？
你离开家有多久了?	离开屋里有多长辰光了？
你穿着和服看上去很漂亮。	侬穿着和服看上去老漂亮个。
你累了，不是吗？	侬吃力了，勿是吗？
你能再给我点茶吗？	侬好再拨我点茶𠲎？
你能帮我找我的钥匙吗？	侬好帮我寻我个钥匙𠲎？
你能猜到我有什么吗？	侬能猜到我有啥𠲎？
你能用这台相机帮我们拍张照吗？	侬好用搿台相机帮阿拉拍张照𠲎？
你脸蛋长得帅，头发理得锃亮，太有型了！	侬面孔末面孔登样，头发末头发做得锃锃亮，卖相瞎好！
你至少该说声”谢谢“吧。	侬至少要谢一声𠲎。
你要什么饮料？	侬要啥个饮料？
你要修得整齐点儿。	修面侬要修修清爽。
你要喝什么茶？泡壶柠檬红茶好吧？	侬要吃啥茶？来壶柠檬红茶倒倒好𠲎？
你要多少钱？	侬要多少钞票？
你要存活期存款，还是定期存款？存“定活两便”也可以的。	侬要存活期存款，还是定期存款？“定活两便”也可以个。
你要干洗还是湿洗？	侬要干汏呢湿汏啊？
你见过鲸鱼吗？	侬见过鲸鱼𠲎？
你觉得你能少发点噪音吗？	侬觉着侬能够少发眼噪音伐？
你认为可以胜任那些方面个工作？	侬认为可以胜任阿里方面个工作？
你让一步吧。	侬放一摸伐。
你记不记得以前见过我？	侬记勿记得以前见过我？
你讲一点素质行吗！	侬素质高一点好𠲎！
你该戒烟。	侬该戒烟。
你该戒烟戒酒了。	侬该戒烟戒酒了。
你该申请这份工作。	侬该申请搿份工作。
你该知道你对家庭的责任。	侬该晓得侬对家庭个责任。
你说得我馋死了！	侬讲得我馋也馋煞唻！
你说有劲吗？	侬讲有劲𠲎？
你说的没有意义。	侬讲个呒没意义个。
你读完那本小说了吗？	侬读完哀本小说了𠲎？
你读给我听的时候，我就可以做缝纫了。	侬读拨我听个辰光，我就可以做针线生活了。
你购房款都付了吗？	侬购房款侪付脱了𠲎？
你走了，我们都会想你的。	侬走了，阿拉侪会得想侬个。
你身体一直非常好，怎么突然间住医院了？	侬一向身体好来死，哪能辣末生头住医院了？
你近来身体好吗？	侬搿抢身体好𠲎？
你还有什么要我帮忙吗？	侬还有啥个要我帮忙𠲎？
你还活着，斯斯克？	侬还活垃海，斯斯克？
你还需要茶吗？	侬还需要茶𠲎？
你这个人真是傻乎乎的，洗洗澡，松松劲，有益血脉调和。	侬搿个人真是戆噱噱，汏汏浴，松松劲，有益血脉调和。
你这个人真是傻瓜一个，这么笨！	侬搿个人真是阿木林一只，介拎勿清！
你这个台秤有问题吗？	侬只磅秤有问题𠲎？
你钱或者信用卡带来没有？	侬钞票或者信用卡带来𠲎？
你除了专业之外，还有什么别爱好吗？	侬除脱仔专业之外，还有啥特别爱好𠲎？
你高兴去哪儿就去哪儿。	侬高兴去阿里搭就去阿里搭。
便宜没好货。	一份价钿一份货。
便宜没好货。	贪钱买老糅。
修面吗？	修面修𠲎？
倒不一定要买东西，练耐力。	倒勿一定要买啥物事，练啥脚劲。
假如你新房子已经装修好，我就来帮你搬家。	假使侬新房子已经装修好，我就来帮侬搬场。
假如你没有这个程序，你现在就可以去下载。	假使侬呒没搿只程序，侬现在就可以去下载。
假如我告诉你，大家不要走来走去，你有意见吗？	假使我告诉侬，大家勿要走来走去，侬有意见𠲎？
做一个可爱的上海人！	做一个可爱个上海人！
做个讨人喜欢的小朋友。	做个讨人欢喜个小朋友。
做完工作一般是五点半回到家里吃晚饭。	做完生活一般五点半回到屋里吃夜饭。
停车场是免费的。	停车场是免费个。
偷鸡不成蚀把米。	偷鸡勿成蚀把米。
先生眼光真好，要不要试戴一下？	先生眼光真好，阿要试试戴戴看？
先生，请出示护照或者身份证，让我登记一下。	先生，请侬出示护照或者身份证，让我登记一下。
公交车迟到了。	公交车迟到了。
公园里有很多人。	公园里有得交关人。
公车上要静了再静。	公车高头要静了再静。
关门。	关门。
再搞点瓜子、腰果、杏仁什么的尝尝。	再弄点瓜子、腰果、杏仁咾啥剥剥。
“再来吧”酒吧要招一个服务员，你有兴趣吗？	“再来吧”酒吧要招一个服务员，侬有兴趣𠲎？
再要开眼界，去看人民广场下面的地下商场。	再要开眼界，去看人民广场下面个地下商场。
再见！有空多来玩儿！	再会！有空多来白相相！
再试也无济于事了。	再试也呒没用了。
再过几年，苏州河沿岸真要成为上海一条亮丽的风景线了。	再过几年，苏州河沿岸真要成为上海一条亮丽个风景线了。
写在那儿十元钱五斤，我可以卖给你十元六斤。	写拉海十元五斤，我可以卖拨侬十元六斤。
几分钟后，电话响了。	几分钟以后，电话响了。
出去之前确认一下所有的灯都关了。	出去之前确认一下所有个灯侪关脱了。
列车已经出发。	列车已经出发。
别多罗嗦。	勿要多罗嗦。
别客气，没事儿。	勿要客气，呒没关系个。
别忘了写邮政编码！	邮政编码勿要忘记写！
别忘了在你的信上贴张邮票。	勿要忘记脱垃海侬个信浪向贴张邮票。
别把鲜花插在牛粪上。	勿要让乌龟吃大麦。
别是小地方出产的冒牌货吧？	勿要是大兴货噢，小地方出产个！
别瞎说啊，你看，我这儿的竹笋是最好的！	帮帮忙噢，侬看看，我搭个竹笋是顶好个！
别等啦，我来招一辆出租汽车。	勿要等唻，我来拦一部差头。
刮脸吗？	修面修𠲎？
到了常熟路站，请你叫我一下。	到了常熟路站，请侬叫一声我。
到外滩去的126路车站，在什么地方？	126路公共汽车站头，到外滩去，拉啥地方？
到现在我又打好了两篇稿子。	到现在我又打好了两篇稿子。
到这儿来转一圈，感觉太好啦！	到搿搭来兜一转，感觉勿要忒好噢！
前几年市政府花了大力气，使苏州河变清了。	前两年市政府花了大力气，使得苏州河变清了。
办公桌上面有一张地图。	办公桌高头有张地图。
勤洗浴，勤理发，勤换衣裳，勤打扫房间，卫生第一。	勤汏浴，勤理发，勤换衣裳，勤打扫房间，卫生第一。
北军行动失败得如丧家之犬。	北军行动失败得屋里也勿认得了。
医生给我把脉。	医生帮我搭脉。
医生，请给这孩子急救。	医生，请帮搿小人急救。
十几个人聚集在火车站前。	十几个人聚集拉火车站前头。
十年后，我们的城市将改变许多。	十年以后，阿拉个城市会得改变交关。
“卖相”、“讲斤头”、“勿是生意经”、“耳朵打八折”等，都有浓厚的商业气息。	“卖相”、“讲斤头”、“勿是生意经”、“耳朵打八折”咾啥，侪有浓厚商业气息。
博物馆的入口在哪？	世博馆个入口勒啥地方?
占建筑总面积百分之几？	占建筑总面积百分之几？
厕所里有人。	厕所里有人。
厕所里有人。	厕所间里有人。
去年夏天，我在农场打半工。	去年夏天，我垃海农场打半工。
去年她离开了日本。	去年伊离开了日本。
参加派对的话，你会穿哪一件衣服？	参加派对个言话，侬会穿阿里件衣裳？
反正到了二十二岁什么都知道了，看书还有什么用呢。	反正到了廿二岁像啥侪晓得了，看书还有啥用场呢。
发给好朋友的请帖上有新郎新娘合影的照片。	发拨要好朋友个请帖浪有新郎新娘合影个照片。
口袋里的钱摸空了没关系，去找自动取款机吧。	袋袋里个钞票摸空勿要紧，去寻自动取款机好唻。
只有你一个人能做到，但你独自一个人是做不到的。	只有侬一个人做得到，但是侬独自一家头是做勿来个。
叫一个腌笃鲜汤吧。	来一只腌笃鲜汤好唻。
叫个清蒸鲈鱼好呢，还是蚝油牛肉好？	叫只清蒸鲈鱼好呢，还是蚝油牛肉好？
叫辆出租车来接我们。	叫步差头来接阿拉。
叫辆出租车来接我们。	叫步的士来接阿拉。
可惜这是真的。	可惜搿是真个。
可能是些公司员工。	大概是点公司员工？
史密斯夫妇现在分居了。	史密斯夫妇现在分居了。
右拐弯马路对面过去一点就到了。	右转弯对马路过去点就到了。
吃一堑长一智。	吃一亏长一智。
吃得太多对健康不好。	吃了忒多对健康勿好。
吃得太多，长得很胖，那就要影响发育。	吃得忒多，长得胖来死，乃末要影响发育。
合同已经到手了，那就出去庆祝一下吧。	合同已经到手了，搿就出去庆祝一下𠲎。
听到她成功的消息，他很高兴。	听到伊成功个消息，伊老高兴个。
听说一个精品鸡鸭血汤，鲜得没话说！	听说一只精品鸡鸭血汤，鲜是鲜得来勿谈！
吹风，你吹哪个式样？	侬吹风吹啥个式样？
告诉我你在湘南做了什么。	告诉我侬垃湘南做了啥。
告诉我你对湘南做了什么。	告诉我侬对湘南做了啥。
告诉我您计划的目的。	告诉我侬计划个目的。
周围环境怎么样？静不静？夜晚闹不闹？	周围环境哪能介？静勿静？夜里向吵勿吵？
和东京比，伦敦不太大。	跟东京比起来，伦敦勿大个。
和东京比，伦敦很小。	帮东京比起来，伦敦老小个。
和你的车比起来，我的车很小。	跟侬个车比起来，我个车老小个。
和你的车比起来，我的车很小。	跟侬部车子一道比，我哀部老小个。
和她争辩是没用的。	跟伊争辩是呒没用个。
和这些金额相对应的是什么？	跟搿眼金额相对应个是啥？
咱们穿马路吧。	阿拉穿马路伐。
哇！这条狗真的大耳獠牙。	喔！搿只狗真个大耳朵獠牙齿。
响了。	响了。
哎呦好难受啊，全身发痒！	喔呦难过唻，浑身痒！
哎哟，撞到你了，对不起！	喔唷，撞着侬了，对勿起！
哦，想起来了，忘记在填报名单的桌子上。	喔，想起来了，忘记拉填报名单个台子高头。
哦，我的白裤子！它是新的。	哦，我个白裤子！伊是新个。
哦！请给我看看。	哦！请拨我看看。
哦，这儿你能走吗？	噢，搿搭侬好走𠲎？
哪一个你喜欢一点？	阿里一只侬欢喜一眼？
哪个方向是朝北？	阿里个方向是朝北？
啊，我认识这个男人！	啊，我认得搿个男人！
喂，张小静在家吗？麻烦你叫她听电话。	喂，张小静垃拉屋里𠲎？麻烦侬叫伊听电话。
喂，我要一辆的士，现在就到华山路200弄40号门口。	喂，我要叫一部的士，现在辰光到华山路200弄40号门口。
喂，是120吗？	喂，120是𠲎？
喂，请问现在能给我马上送一叠稿子吗？	喂，请问现在脱我马上送一叠稿子好𠲎？
喂，这橘子多少钱买一斤啊？	哎，搿眼橘子几钿一斤啊？
因为下雨，我们不能出去。	因为落雨，阿拉勿好出去。
因为今天明天我休息，所以趁机会快点搬好它。	今朝明朝我休息咾，趁机会快点搬好伊。
因为你们公司的业务能够发挥我的特长。	因为㑚公司个业务能够发挥我个特长。
因为它不是你的母语，你的发音会永远不准。	因为勿是侬个母语，发音永远发勿准个。
因为我想成为翻译。	因为我想成为翻译。
因为现在上海家家都是独生子女，家长对小孩的读书非常重视。	现在上海家家侪是独生子女咾，家长对小囡个读书邪气重视。
在一天之内完成它几乎是不可能的。	垃海一天之内完成伊几乎是勿可能个。
在七世纪的时候，印度数学家婆罗摩笈多已经得到了方程x²-92y²=1的最小正整数解。	垃海七世纪个辰光，印度数学家婆罗摩笈多已经得到了方程x²-92y²=1个最小正整数解。
在公车上，一个陌生人和我说了话。	垃海公车高头，一个陌生人跟我讲了言话。
在北京，胡同是由四合院的传统居所排形成。	拉垃北京，胡同是由四合院传统个居所来排成个。
在埃及说什么语言？	垃海埃及讲啥个语言？
在城市里行驶的车辆数量增加了。	垃海城市里向开个车子数量增加了。
在延安路高架上看两面的上海风光，盖了帽了！	拉延安路高架高头看两面个上海风光，瞎嗲！
在您说的话里有很多真相。	侬讲个言话里向有交关真相。
在明天前完成报告几乎是不可能的。	垃海明朝之前完成报告几乎是勿可能个。
在某种程度上你是对的，但我还是有疑问。	垃海某种程度上侬是对个，但是我还是有疑问。
在美国说英语。	垃海美国讲英文个。
在英国的时候，我经常看参考书。	垃海英国个辰光，我经常看参考书。
在这个城市，白人和黑人间的争端愈演愈烈。	垃海搿个城市，白人跟黑人之间个争端越来越结棍了。
在这儿等到他回来为止。	垃海搿搭等到伊回来为止。
在这儿茶室里碰头，情调不错。	垃拉搿搭茶室里碰头，情调勿推扳。
在这种天气下，我最好是待在家里而不要出去。	垃海搿种天气下头，我最好是登了屋里向而勿要出去。
在里弄的最里边。	垃盖弄堂着着里向头。
在靠你右首那边。	拉垃靠侬右手一面嗒。
地上拿扫帚扫一扫。	地浪向拿扫帚扫一扫。
地球绕着太阳转。	地球围牢太阳转。
坐这列火车，走哪号通道？	乘搿部火车，走几号通道？
夏天没空调，我什么都做不了。	夏天呒没空调，我啥侪做勿了。
夏威夷是一个大众化旅游圣地。	夏威夷是一个大众化个旅游圣地。
外甥今年考大学少了几分没有考进重点大学。	外甥今年考大学缺几分呒没考进重点大学。
多少钱一斤？	几钿一斤？
多遗憾啊！	多遗憾啊！
夜里游泳很危险。	夜里向游泳老危险个。
大好的前途摆在他面前。	大好个前途摆了伊面前。
大学在20年前由他的父亲建立。	大学垃海20年前头由伊拉爷建立个。
大家的行李都拿齐了吗？	大家个行李侪拿齐了𠲎？
大家都是朋友，以后多多关照。	大家侪是朋友，以后多多关照。
大家都知道她的英语说得很好。	大家侪晓得伊个英文讲了老好个。
大家都说他跟他爸爸是一个模子刻出来的。	大家侪讲伊跟伊拉爷是一个模子刻出来个。
大部分男生喜欢棒球。	大部分男生欢喜棒球。
大部分观众是年幼的儿童。	大部分观众是年幼个儿童。
天不怕，地不怕，就怕温州人说温州话。	天勿怕，地勿怕，就怕温州人讲温州闲话。
天快亮了，我要动身了。	天亮快了，我要动身了。
天气一天天冷下来了。	天一日日拉海冷下来了。
太棒了！是毛坯房还是装修房？	勿要忒女赞噢！是毛坯房还是装修房？
太难看了，有没有新式一点个？	忒难看了，有勿有新式一点个？
失之毫厘，谬之千里。	失之毫厘，谬之千里。
头还有点痒吧？如果不痒，就去冲掉它好吗？	头还痒兮兮𠲎？勿痒末，去冲脱伊好𠲎？
奇怪的声音从门后传来。	奇怪个声音从门后头传过来。
奈良是个非常古老的城市。	奈良是个邪气古老个城市。
奶奶觉得板床比“席梦思”睡着舒服。	奶奶觉着睏板床比睏“席梦思”适意。
她一到，我们就开始。	伊一到，阿拉就开始。
她一直和她的兄弟争吵。	伊一直跟伊拉兄弟吵相骂。
她上飞机前，给我招了招手。	伊上飞机以前，脱我招了招手。
她下周日出发去美国。	伊下个礼拜天出发去美国。
她下周日回家，也就是10号。	伊下个礼拜天回来，也就是10号。
她不喜欢我说话的方式。	伊勿欢喜我讲言话个方式。
她两眼于墨黑。	伊两只眼睛等于墨出黑。
她习惯在屋顶上拉小提琴。	伊习惯垃海屋顶高头拉小提琴。
她买了件羊毛套衫给他。	伊买了件羊毛套衫拨伊。
她什么时候生的？	伊啥个辰光生个？
她从屋顶上下来了。	伊从屋顶高头下来了。
她休假期间花了一大笔钱。	伊休假个哀段辰光花了一大笔钞票。
她住在纽约。	伊住拉纽约。
她住在罗素广场56号。	伊住拉罗素广场56号。
她冷了，所以她开了暖气。	伊冷了，所以伊开了暖气。
她叫玛丽，是我的秘书。	伊叫玛丽，是我个秘书
她和她妹妹一样亲切。	伊跟伊拉阿妹一样亲切。
她在一棵树下坐着。	伊垃海一棵树下头坐垃海。
她在海边有一栋房子。	伊垃海海边有一栋房子。
她在海边有一间小屋。	伊垃海海边有一间小房子。
她太放任她的孩子们了。	伊忒由牢伊个小人了。
她嫁给了一个有钱人。	伊嫁畀勒一个有铜钿人。
她对大家都很亲切。	伊对大家侪老亲切个。
她对她的孩子非常生气。	伊对伊个小人非常生气。
她就是不讲道理。讨厌死了。	伊就是勿讲道理。讨厌煞了。
她帮她爸爸干了花园里的活。	伊帮伊拉爸爸做了花园里个生活。
她弄丢了她的帽子，但很快就找回来了。	伊拿伊个帽子弄落脱了，但是老快就寻回来了。
她很想要一条新的连衣裙。	伊老想要一条新个连衣裙个。
她忙着编织。	伊忙垃海编织。
她打扮得妖里妖气，一副傻样！	伊打扮得妖里妖气，戆头势勿谈！
她把她仅有的钱都弄丢了。	伊拿伊仅有个钞票侪弄落脱了。
她把她的座位让给了一个老人。	伊拿伊个座位让拨了一个老人。
她把自己关在房里。	伊挪自家关拉房间里。
她星期天也只能去公司做义务劳动了。	伊礼拜日也只好到公司去做义务劳动了。
她昨天自杀了。	伊昨日自杀了。
她是什么时候出生的？	伊是啥个辰光养出来个？
她是由她的祖母带大的。	伊是由伊个祖母带大的。
她有两只猫。一只是白色的，另一只是黑色的。	伊有两只猫。一只是白颜色个，另一只是黑颜色个。
她有蓝色的眼睛。	伊有蓝颜色个眼睛。
她正要离开家。	伊正要离开屋里。
她每天挣30美元。	伊每天赚30美元。
她没有任何亲戚朋友照顾她。	伊呒没任何亲戚朋友照顾伊。
她没有辜负我们的期望。	伊呒没辜负阿拉个期望。
她没说正，也没说否，就让我们兜了一个圈子。	伊呒没讲正，也呒没讲否，就帮阿拉兜了只圈子。
她现在正待在她叔叔家。	伊现在正登拉伊拉爷叔屋里。
她班上大约有40个学生。	伊班浪向大概有40个学生。
她用不着工作。	伊用勿着工作个。
她申请了签证。	伊申请了签证。
她穿了一件红的旗袍。	伊穿了一件红顔色个旗袍。
她给客人看了她的宝宝。	伊拨客人看了伊个宝宝。
她给我讲了一个有趣的故事。	伊帮我讲了一个有趣个故事。
她认为计划很好，但不可行。	伊认为计划老好，但是行勿通。
她认识的英语词比我认识的多十倍。	伊晓得个英语词有我晓得个十倍。
她讲法语吗？	伊讲法语𠲎？
她还没有到来。	伊还呒没到。
她迷路了，紧接着天开始下雨了。	伊迷路了，接下来天开始落雨了。
她选了现代音乐的一个典型例子。	伊选了现代音乐个一个典型例子。
她邀请我们去她的生日派对。	伊邀请阿拉去伊个生日派对。
她骑自行车去上学。	伊踏脚踏车去上学。
好习惯是从小养成的。	好习惯是从小养成个。
好吧，好吧。你给我份量要称足。	好好好。侬份量要称称足。
好吧，薪金多少？有休息天吗？	好个呀，薪金多少？休息日有𠲎？
好嘞！	一句言话！
好多马路商店集中，商品琳琅满目，真好看！	交关马路商店集中，商品琳琅满目，真好看！
好好想想，开动脑筋。	好好想想，动动脑筋。
好的，但我们先吃晚饭吧。	好个，但阿拉先吃夜饭𠲎。
好的。房间里长途电话可以直拨吗？	好个。房间里长途电话可以直拨个𠲎？
如何克服日元升高是个大问题。	哪能克服日元升高是个大问题。
如何料理黑鲷：做刺身是最好吃的。	哪能料理黑鲷：做刺身是最好吃个。
如果不是因为有你的帮助，我不可能完成了这个工作。	如果勿是因为有侬个帮助，我勿可能完成了搿个工作。
如果他年轻一点，他将很适合这个职位。	如果伊年轻一眼，伊会得老适合搿个职位个。
如果你快一点，还能赶上他。	如果侬快一眼，还能赶上伊。
如果你想活得久一点就戒烟。	如果侬想活了长一眼就戒烟。
如果可能的话，周二过来。	如果可能个言话，礼拜二过来。
如果可能的话，我想环游世界。	如果可能个言话，我想环游世界。
如果小姐要的话，可以打八折。	小姐要个言话，好打个八折。
如果我是你，我也会这么做。	如果我是侬，我也会搿能做。
如果我有时间有钱，我要到欧洲去旅游。	如果我辰光有钞票够，我要到欧洲去旅游。
如果我这点活儿可以做完，我将在星期一去南京。	如果我搿眼生活可以做光，我要拉礼拜一到南京去。
如果考取了，要学几个月？	假使考取了，要学几个月？
妈妈为我准备了午饭。	妈妈帮我准备了中饭。
姐姐在市场买了一点茄子、土豆、丝瓜和大白菜。	阿姐拉垃小菜场买了眼落素、洋山芋、夜开花跟黄芽菜。
姑妈她单位不景气，她下岗以后去做月嫂收入却不少。	孃孃拉单位勿景气，伊下岗以后去做月嫂收入倒也勿少。
姑娘，今天你上门来，有些什么事啊？	妹妹，今朝侬上门来，有眼啥个事体啊？
威尼斯的圣马可广场在夏季总是挤满了游客。	威尼斯个圣马可广场垃海夏天总归是轧满了游客。
子女培养全社会都很关心，教育要进行改革。	子女培养全社会侪邪气关心，教育要进行改革。
字典上写的不总是对的。	字典高头写个勿总归是对个。
学习其他国家的文化很有趣。	学习其他国家个文化老有意思个。
学校8点半开始上课。	学堂8点半开始上课。
孩子们应该每天喝牛奶。	小人应该每天吃牛奶。
孩子们洗了他们的脚。	小人汰了伊拉个脚。
孩子在这条河里游泳太危险了。	小人垃海搿条河浜里游泳太危险了。
孩子抓住了猫的尾巴。	小人抓牢了猫个尾巴。
它从哪里离开的？	伊从阿里搭离开个？
宗教是人民的鸦片。	宗教是人民个鸦片。
宝宝开始哭了。	宝宝开始哭了。
实在抱歉，真对不起你！	实在是抱歉，真对侬勿起！
实验失败了。	实验失败了。
实验证明了他的理论。	实验证明了伊个理论。
害人之心不可有，防人之心不可无。	害人之心勿可以有，防人之心勿可以呒没。
寄挂号信是不是可以快一点？	寄挂号信是勿是好快一点？
对不起。	对勿起。
对不起。我收回我的话。	勿好意思，就当刚才闲话我没讲过。
对不起，没有身份证是不能领汇款的。	对勿起，呒没身份证是勿好领汇款个。
对，是我们经理。	对个，是阿拉经理。
小伙子陪女朋友来玩，看得眼花缭乱。	小伙子陪女朋友来白相，眼睛看得五花六花。
小冰箱很脏。	小冰箱老龌龊个。
小区安全吗？夜晚有照明设施吗？	小区安全𠲎？夜里有照明设施𠲎？
小区旁边出行方便吗？	小区旁边出行方便𠲎？
小女孩闭上了眼睛听了牧师。	一个女小位闭上了眼睛，听牧师讲。
小姐，今天晚上有没有空房间？	小姐，今朝夜到有勿有空房间？
小姐已经有一个戒指，要不要配一条铂金项链？	小姐已经有一只戒指，要勿要配条铂金项链？
小姐，我想买件式样好一点的西装。	小姐，我想买一件西装，样子好一眼个。
小姐，这封信寄到旧金山，贴多少邮票？	小姐，搿封信寄到旧金山，邮票贴多少？
小明还不知道他明年去哪儿。	小明还勿晓得伊明年去阿里搭。
少管闲事!	少管眼闲事!
尤其是要注意你吃的和喝的东西。	尤其是要注意侬吃个跟喝个物事。
就在这儿停车吧。	就搿搭停车好唻。
就我所知，他从没准时来过。	就我所晓得个，伊从来呒没准时来过。
就是因为他不成材他爸看不起他。	就是因为伊勿成材伊垃爷看勿起伊。
尽可能早点下来。	尽可能早点下来。
尽可能清楚地表达您自己。	尽可能清爽个表达侬自家。
尽快来。	尽快来。
尽早让我知道结果。	尽早让我晓得结果。
尽管我明白您说的话，但我不能同意您的看法。	尽管我明白侬讲个闲话，但我勿能同意侬个看法。
屋子的采光条件要好一点，不要在墙角上的房子。	房子个采光条件要好一点，勿要角角头个房子。
山坡上有一个茅屋。	山浪向有一间茅屋。
山坡上有一间小屋。	山浪向有一间小房子。
山坡上有一间村屋。	山浪向有一间村屋。
工资是你的零头；上班时间大家随便混混。	工资末，是侬个零头；上班末，大家淘淘浆糊。
左上角的那个动物是条龙。	左上角个哀个动物是条龙。
差五分十点。	十点缺五分。
已经等了半个小时了。	已经等了半个钟头了。
已经退休了，但还常常被他们请去做顾问。	退休也退休了，还常常拨伊拉请得去做顾问。
巴黎是法国的首都。	巴黎是法国个首都。
布什继里根之后当上了总统。	布什继里根之后当上了总统。
带鱼吃干“煎”，豆板可油“氽”。	带鱼吃干“煎”，豆板好油“氽”。
帮我一下。	帮我一记。
床下有一只猫。	床下头有一只猫。
底特律因它的汽车工业而出名。	底特律因为伊个汽车工业而出名。
建筑物在地震中摇晃。	建筑物垃海地震当中摇来摇去。
开电视。	开电视。
开门的时候我把锁弄坏了。	开门个辰光我挪锁弄坏脱了。
当今，海派文化正在注入新的活力发扬光大，上海人都充满信心。	当今，海派文化正拉注入新个活力发扬光大，上海人侪充满信心。
当在餐馆里时，不能点炒鱿鱼。	当垃餐馆里个辰光，勿好点炒鱿鱼。
当培训期满，我就可以做一个银行出纳员。	一当培训期满，我就可以做一个银行出纳员。
当她发现他们还没有学校，她就办了一个。	当伊发现伊拉还呒没学堂，伊就办了一个。
当局者迷，旁观者清。	当局者混，旁观者清。
当我们才赶到，他们的已经开始跳起舞来了。	当阿拉赶到个辰光，伊拉舞已经开始跳起来了。
当我看到他的时候，我想到了我的祖父。	当我看到伊个辰光，我想到了我个祖父。
当时，国画、京戏、通俗小说、流行歌曲，都是一流的。	当时，国画、京戏、通俗小说、流行歌曲，侪是一流个。
当然会的，不过上海话不太会讲。	当然会个，不过上海言话讲大勿来。
往北拐弯走到第二条弄堂就是。	朝北转弯走到第二条弄堂就是了。
待在那儿别动。	登了哀搭勿要动。
很多人把成功和拥有很多钱等同起来。	交关人拿成功跟有交关钞票划了等号。
很少人这么认为。	老少人搿能认为。
很难说明天的天气将会怎样。	老难讲明朝个天气会得哪能。
徐家汇商圈高中低档商品俱全，错位经营。	徐家汇商圈高中低档商品俱全，错位经营。
得不到的东西就最想得到。	得勿到个物事就最想得到。
德国与意大利结盟了。	德国跟意大利结盟了。
德国出了很多科学家。	德国出了交关科学家。
德国曾是意大利的同盟国。	德国曾经是意大利个同盟国。
忙了不注意休息和锻炼，待会儿生起大病来就来勿及了。	忙了勿注意休息咾锻炼，晏歇点生大毛病起来来勿及。
快一点，你就能赶上火车了。	快一眼，侬就赶得上火车了。
快一点好吧！	快一点好𠲎！
怎么拿了东西不付钱就走了！	啥挪子物事钞票勿付就跑了！
怎么这么远啊？	哪能介远啊？
怎样做怎么不告诉我听？	哪能做法哪能勿告诉我听？
您一旦开始了，就应该继续下去。	侬一旦开始了，就应该继续下去。
您一般几点下班？	侬一般几点钟下班？
您不能在这里游泳。	侬勿能垃海搿搭游泳。
您不需要乘出租车。	侬勿需要乘差头。
您为什么指责我儿子？	侬为啥指责我儿子？
您什么时候完成的？	侬啥辰光完成个？
您从哪儿来的？	侬从阿里搭来个？
您会做您认为是正确的事吗？	侬会得做侬认为是正确个事体𠲎？
您会骑马吗？	侬会骑马𠲎？
您参观过东京塔吗？	侬参观过东京塔𠲎？
您喜欢做什么？	侬欢喜做啥？
您多久见他一次？	侬多长辰光见伊一趟？
您好吗？	侬好𠲎？
您好，我是某某人，此时正在找第一次工作。	侬好，我是某某人，现在垃海寻第一次工作。
您学习吗？	侬学习𠲎？
您学英语吗？	侬学英语𠲎？
您对此怎么看？	侬对搿哪能看？
您已经吃过药了吗？	侬已经吃过药了𠲎？
您应该马上做。	侬应该马上做。
您必须马上做。	侬必须马上做。
您想再喝杯茶吗？	侬再想吃杯茶伐？
您愿意把您的字典借给我吗？	侬愿意拿侬个字典借拨我伐？
您明白作家写的东西的意思吗？	侬明白作家写个物事个意思𠲎？
您昨天为什么离开教室？	侬昨日为啥离开教室？
您最喜欢哪个季节？	侬最欢喜阿里个季节？
您有火柴吗？	侬有自来火伐？
您来这儿干嘛？	侬来搿搭做啥？
您现在想要什么？	侬现在想要啥？
您生气了吗？	侬生气了𠲎？
您的建议在会议上提过了。	侬个建议垃海会议高头提过了。
您的结论非常值得商榷。	侬个结论非常值得商榷。
您的脉搏正常。	侬个脉搏正常。
您的行为不得体。	侬个行为勿得体。
您能帮我修这双鞋吗？	侬能帮我修搿双鞋子𠲎？
您能把电视开小声点吗？	侬好拿电视开小声眼𠲎？
您要多少钱？	侬要多少钞票？
您记不记得以前见过我？	侬记勿记得以前见过我？
您该去派对。	侬该去派对。
您该申请这个职位。	侬该申请搿个职位。
您该知道您对家庭的责任。	侬该晓得侬对家庭个责任。
您说的没有意义。	侬讲个呒没意义个。
您读完那本小说了吗？	侬读完哀本小说了𠲎？
您走路去学校吗？	侬走路去学堂𠲎？
您运气多好啊！	侬运气多少好啊！
您这么做很荒唐。	侬搿能做老荒唐个。
您进房前必须脱鞋。	侬进房间之前必须脱鞋子。
情况一天比一天差。	情况一日比一日差。
想吃多少饼干就吃多少。	想吃多少饼干就吃多少。
意大利的国际号码前缀是三十九(+39)。	意大利个国际号码前缀是三十九(+39)。
慢走，这儿有盏灯开一下。	走好，走好，搿搭盏灯开一开。
成千上万的人对这个广告很失望。	成千上万个人对搿个广告老失望个。
我一整天都在看这本小说。	我整个一日天看了搿本小说。
我一点也不羡慕你的生活。	我一眼也勿惹眼侬个生活。
我一直等到了最后一分钟。	我一直等到了末级一分钟。
我不会卖的。	我不会卖个。
我不会说德语。	我勿会讲德语。
我不喜欢穷人，他们只想着钱。	我勿欢喜穷人，伊拉只想着钞票。
我不够钱去旅行。	我去旅游钞票勿够。
我不想买这样的沙发。	搿能个沙发我勿想买。
我不想坐汽车去，宁可走去。	我勿想乘汽车去，情愿走得去。
我不明白为什么你这么批评他。	我勿明白侬为啥搿能批评伊。
我不明白您想说什么。	我勿明白侬想讲啥。
我不来谁来呀？	我勿来末啥人来啊？
我不知道她什么时候从法国回来。	我勿晓得伊啥辰光从法国回来。
我不知道她结婚了。	我勿晓得伊结婚了。
我不知道怎么做才能结束这个月。	我勿晓得哪能做才好结束搿个号头。
我不知道这个湖有多深。	我勿晓得搿条湖浜多少深垃海。
我不等谁。	我勿等啥个人。
我不能让自己做这样的事。	我勿能让自家做搿能个事体。
我不记得你的名字了。	我勿记得侬个名字了。
我丢了我的伞。	我拿我个伞落脱了。
我为什么一定要知道呢？	我为啥一定要晓得呢？
我为你的行为感到可耻。	我为侬个行为感到可耻。
我为她翻译了好几次这个词。	我为伊翻译了好几趟搿个词。
我为您的行为感到可耻。	我为侬个行为感到可耻。
我也听过一个类似的故事。	我也听过一个类似个故事。
我也想要和你身上那件同样的外套。	我也想要脱侬身浪向哀件同样个外套。
我也许不会反对他去。	我作兴勿会反对伊去。
我也过得很愉快。	我也过了老愉快个。
我买了一支钢笔，但我把它丢了。	我买了一支钢笔，但我拿伊落脱了。
我买了些衣服。	我买了眼衣裳。
我买了台新电视机。	我买了台新个电视机。
我买了菜，做好了饭，等我儿子来吃饭。	我买了小菜，烧好了饭，等我儿子来吃饭。
我买好了，两盒西洋参，五斤苹果，还有十只蟹带去。	我买好了，两盒西洋参，五斤苹果，还有十只蟹带去。
我买好了徐家汇附近的高层。	我买好了徐家汇附近个高层。
我五点到你家来接你。	我五点钟到㑚屋里来接侬。
我今天感觉好多了。	我今朝感觉好交关了。
我今天碰上你很高兴。	我今朝碰到侬交关开心。
我今天要准备晚饭。	我今朝要准备夜饭。
我从不吃肉。	我从来勿吃肉个。
我从来没说过我是专家。	我从来没讲过我是专家。
“我从没想过”，老先生说道：“我们该做什么？”	“我从呒没想过”，老先生讲：“阿拉该做啥？”
我从窗口爬进来的。	我从窗口头爬进来垃。
我从马来西亚来的妈妈觉得那三匹马马马虎虎。	我个从马来西亚来个姆妈觉着哀个三匹马马马虎虎。
我以前从没见过她。	我老早从来呒没见过伊。
我们也去了庙里。	阿拉也去了庙里。
我们决定采用你的想法。	阿拉决定采用侬个想法。
我们决定采用您的想法。	阿拉决定采用侬个想法。
我们则一边煮着蹄膀，一边吃着螺蛳，口里哼着沪剧，真是悠然自得！	阿拉叫蹄膀笃笃，螺蛳嗍嗍，沪剧哼哼，邪气小乐惠！
我们到了春分去。	阿拉到春分去个。
我们发现他是她的父亲。	阿拉发现伊是伊个爷。
我们吃面包夹黄油。	阿拉吃面包夹黄油。
我们同意了第二天一早开始。	阿拉同意了第二天一早开始。
我们在下个加油站停一下。	阿拉垃海下个加油站停一下。
我们坐着看电视。	阿拉坐拉海看看电视。
我们城市的动物园又大又新。	阿拉城市个动物园又大又新。
我们大概去了，不过要看天气怎么样再决定。	阿拉大概去个，不过要看天气哪能再决定。
我们学校在市中心。	阿拉学堂垃海市中心。
我们将于下周日结婚。	阿拉会得垃海下个礼拜天结婚。
我们常常做到下午一点，盒饭是送上来的。	阿拉常常做到下半天一点钟，盒饭是送上来个。
我们应该告诉孩子怎么保护自己。	阿拉应该告诉小人哪能保护自家。
我们必须保持家庭传统。	阿拉必须得保持家庭传统。
我们必须考虑到他很年轻。	阿拉必须考虑到伊老年轻个。
我们想要一条新毯子。	阿拉想要一条新毯子。
我们把书桌整理干净吧。	阿拉挪写字台整理清爽𠲎。
我们把他称为“英雄”，但是他却背叛了我们。	阿拉拿伊称为“英雄”，但是伊却背叛了阿拉。
我们整个夏天都和他们待在一起。	阿拉整个夏天侪跟伊拉登了一道。
我们有个同事在西班牙。	阿拉有个同事垃海西班牙。
我们有你的尺寸，但是没有那个颜色。	阿拉有侬个尺寸，但是呒没哀只颜色。
我们有只烤乳鸽，吃上去又嫩又香。	阿拉有只烤乳鸽，吃起来嫩笃笃，香喷喷。
我们正要进房间。	阿拉正要进房间。
我们没机会赢那些一流选手。	阿拉呒没机会赢哀眼一流选手。
我们热了。	阿拉热了。
我们爬上了一个陡坡。	阿拉爬上了一个陡坡。
我们玩过了。我们输了。咱们从新来过吧？	阿拉白相过了。阿拉输脱了。再从新来过伐？
我们现在去吧。	阿拉现在去𠲎。
我们的孩子喜欢狗，但我更喜欢猫。	阿拉个小人欢喜狗，但我更加欢喜猫。
我们的花园布满了杂草。	阿拉个花园长满了杂草。
我们的计划从一开始就出错了。	阿拉个计划从一开始就错脱了。
我们看东西不是看其实质，而是以我们的主观意识看它们的。	阿拉看物事勿是看伊拉个实质，而是以阿拉个主观意识来看伊拉个。
我们看见池里有很多活鱼。	阿拉看见池里向有得交关活鱼。
我们等雨停吧。	阿拉等雨停𠲎。
我们要回去啦，你托我们的事情一定留心着。	阿拉要回去唻，侬托阿拉个事体一定留心拉海。
我们认为他的生意理所当然会获得成功。	阿拉认为伊个生意理所因当会得得到成功个。
我们认为这份报告是假的。	阿拉认为搿份报告是假个。
我们认识有好些年了。	阿拉认得有交关年数了。
我们跟爸爸妈妈已经分开住分开吃了。	阿拉脱老爸老妈已经分开住分开吃了。
我们还有做面膜、修眉毛、蒸面、香熏、指掐贴花、皮肤护理什么的。	阿拉还有得做面膜、修眉毛、蒸面、香熏、指掐贴花、皮肤护理咾啥。
我们都期待看到你和你的家人。	阿拉侪期待看到侬跟侬个屋里向人。
我们都认为你的想法是行不通的。	阿拉侪认为侬个想法是行勿通个。
我们都认为您的想法是行不通的。	阿拉侪认为侬个想法是行勿通个。
我们采取了强有力的预防措施。	阿拉采取了强有力个预防措施。
我会不高兴，但我不会自杀。	我会得勿高兴，但我不会得自杀。
我会回来的。	我会得回来个。
我会在九点钟回来。	我会得垃海九点钟回来。
我会尽快完成的。	我会尽快完成个。
我会尽量不打扰你复习。	我会得尽量不打扰侬复习个。
我会弹钢琴。	我会得弹钢琴。
我会教你怎么开车。	我会教侬哪能开车。
我会给你一个好的建议。	我会拨侬一个好个建议。
我会给你开个药方。	我会帮侬开个药方。
我会给您一个好的建议。	我会拨侬一个好个建议。
我会给您所有我能提供的帮助。	我会拨侬所有我能提供个帮助。
我会说一点儿苏格兰盖尔语。	我会得讲眼苏格兰盖尔文。
我住在广州。	我住垃广州。
我倒觉得挺好的。	我倒觉着蛮好。
我借给他一盘CD。	我借拨伊一张CD。
我做完功课后，就去睡觉了。	我做好功课以后，就去困觉了。
我做完我的功课后，就读这本书。	我做好我个功课以后，就读搿本书。
我偶尔会在俱乐部碰到他。	我难班会得垃海俱乐部碰到伊。
我全心全意地爱你。	我全心全意个爱侬。
我养了一只母猫。	我养了一只母猫。
我再三申明无罪，但是没人听我讲。	我再三申明无罪，但是呒没人垃海听我讲。
我再也没钱了。	我再也呒没钞票了。
我决定不去欧洲了。	我觉得勿去欧洲了。
我刚来到这里。	我刚刚到搿耷。
我刚知道你在生病，所以下了班来看望你。	我刚刚晓得侬拉生病，葛咾下仔班来望望侬。
我去公园散了步。	我去公园散了散步。
我去医院看了我的老婆。	我去医院看了阿拉老婆。
我去听他的演讲去晚了。	我去听伊个演讲去晏了。
我去把老王找来。	我去拿老王寻得来。
我去过罗马。	罗马我去过。
我发现了我爸爸收藏了30年的报纸。	我发现了阿拉爸爸收藏了30年个报纸。
我发现他在花园里干活。	我发现伊垃海花园里向做生活。
我可以不慌不忙吃牛奶面包鸡蛋，或者泡饭酱菜。	我可以笃笃定定吃牛奶面包鸡蛋，或者泡饭酱菜。
我可以做中英双向翻译，参加跟外国人交际谈判。	我可以做中英双向翻译，参加脱外国人交际谈判。
我可以打扰你一下吗？	我可以打扰侬一下𠲎？
我可以用支票付吗？	我可以用支票付𠲎？
我可以被原谅吗？	我可以被原谅𠲎？
我可以要个纸袋吗？	我可以要个纸头袋袋伐？
我可以问你个问题吗？	我可以问侬个问题𠲎？
我可能搞错了。	我可能搞错脱了。
我吃午饭的时候还打过两个电话，所以那个时候还在的。	我吃中饭个辰光还打过两只电话，所以搿个辰光还垃拉个。
我听了，但什么也没听到。	我听了，但是啥也呒没听到。
我听到这个消息很吃惊。	我听到搿个消息老吃惊个。
我听到这个非常开心。	我听到搿个邪气开心。
我听到门关了。	我听到门关了。
我和疯子唯一的区别是我不是疯子。	我跟疯子唯一个区别是我勿是疯子。
我咳嗽，还有点发烧。	我咳嗽，还有眼眼汗热。
我唱卡拉OK，从小时候的歌唱起，一直唱到劲歌金曲最新版。	我唱卡拉OK，从小辰光歌唱起，一直唱到劲歌金曲最新版。
我喉咙很干。	我喉咙老干个。
我喜欢她的风格：她很积极并且知道自己要什么。	我欢喜伊个风格：伊老积极个而且晓得自家要啥。
我喜欢画油画，但是我不想拿它做我的终身职业。	我喜欢画油画，但是我勿想拿伊做我个终身职业。
我喜欢绿颜色。	我欢喜绿颜色。
我在一个大商场里买了一件衬衫。	我拉垃个大个商场里向买了件衬衫。
我在上海虹桥路850弄22号1602室。	我垃拉上海虹桥路850弄22号1602室。
我在两个半小时以前就吃了午饭。	我拉两个半钟头以前就吃了中饭。
我在两年前吃过一次。	我拉两年前吃过一趟。
我在医院里住了几个礼拜。	我医院里住了几个礼拜。
我在想哪个跑步运动员会跑第一。	我垃海想阿里个跑步运动员会得跑第一。
我在报纸上看到了它。	我垃海报纸高头看到伊了。
我在烫我的手绢。	我垃海烫我个绢头。
我在米兰工作。	我垃海米兰工作。
我多买一些，可以便宜点吗？	我多买点，好口强一眼𠲎？
我头撞到了门，肿了一块。	我头撞到了门，肿了一块。
我头痛。可能我该吃阿司匹林。	我头痛。可能我要吃眼阿司匹林。
我好久没见到她了。	我交关辰光呒没见到伊了。
我妹妹21岁，是个大学生。	阿拉阿妹21岁，是个大学生。
我妹妹嫁给了一个医生。	阿拉阿妹嫁拨了一个医生。
我妹妹每周上两次钢琴课。	阿拉阿妹每周上两次钢琴课。
我妹妹目前不学习。	阿拉阿妹目前勿读书。
我学英语学了4年了。	我学英文学了4年了。
我家离火车站很近。	阿拉屋里离火车站老近个。
我对他的态度变了。	我对伊个态度变脱了。
我对别人都不好，因为你发指示叫我来谈谈话的啊。	我对别人侪勿好，因为侬发调头叫我来讲讲言话咾。
我对外籍员工没有偏见。	我对外籍员工呒没偏见。
我对摄影感兴趣。	我对摄影感兴趣。
我对音乐非常感兴趣。	我对音乐邪气感兴趣。
我将确保你们在第一年后有一个增长。	我会得确保㑚垃海第一年以后有一个增长。
我尊敬长辈。	我尊敬长辈。
我小个便，带好围巾，就可以走了。	我小个便，带好围巾，就可以跑了。
我小时候常常独自玩耍。	我小辰光经常一伽头白相。
我就住在愚园路1136弄2号。	我就住拉愚园路1136弄2号。
我尽量留着胃吃甜点。	我尽量留了胃吃甜点心。
我已经刷卡了。	我已经刷过卡了。
我已经好久没有去锻炼了。	我已经长远呒没去锻炼了。
我已经看过这部电影了。	我已经看过搿部电影了。
我希望将来成为一名牙医。	我希望将来成为一名牙医。
我带你们去。	我带㑚去。
我应该打扫我的房间。	我应该打扫我个房间。
我开始流血了。	我开始流血了。
我开门的时候弄坏了锁。	我开门个辰光挪锁弄坏脱了。
我弟弟手里拿着一个摄像机。	阿拉阿弟手里向挪了一部摄像机。
我弟弟没我两年前高。	阿拉阿弟呒没我两年前头高。
我弹钢琴。	我弹钢琴。
我当然同意的。	我当然同意个。
我很喜欢跳舞。	我老欢喜跳舞个。
我很惊讶你们竟然那么天真。	我老惊讶㑚竟然介天真。
我很惊讶您竟然那么天真。	我老惊讶侬竟然介天真。
我很感激你在我生病的时候照顾我。	我老感激侬垃海我生毛病个辰光照顾我。
我很抱歉辜负了你的计划。	我老抱歉辜负了侬个计划。
我很爱你。	我老欢喜侬个。
我怀孕四个月了。	我已经大肚皮四个月唻。
我总是在离手不远的地方放一本字典。	我总归是拉海离手勿远个地方放一本字典。
我想你读一下这封信。	我想侬读读搿封信。
我想减肥。	我想减肥。
我想去买个优盘，你和我一起去行吗？	我想去买只优盘，侬得我一道去好𠲎？
我想去西雅图。	我想去西雅图。
我想学习法语。	我想学法语。
我想我们可以成为好朋友。	我想阿拉可以成为好朋友。
我想把阅读灯关了，行吗？	我想拿阅读灯关脱，来塞𠲎？
我想是这张好。	我想是搿张好。
我想知道这个冬天在我们的城市会不会下雪。	我想晓得搿个冬天垃海阿拉个城市会勿会落雪。
我想给你提个建议。	我想帮侬提个建议。
我想要一间便宜点的双人房。	我想要一间便宜眼个双人房。
我想要你的一张照片。	我想要侬个一张照片。
我想要去伦敦。	我想要去伦敦。
我想起来关门后，我把钥匙留在里面了。	我想起来关门以后，我拿钥匙留拉里向了。
我感冒了还发烧。	我伤风了还发汗热。
我懒得做作业。	我懒得做功课。
我或者去看电影，或者去看歌剧。	我或者去看电影，或者看歌剧。
我打游戏。	我打游戏。
我打算八点在房里吃早餐。	我打算八点钟垃房间里吃早餐。
我打赌他没搞定。	我打赌伊呒没搞定。
我把我仅有的钱给了那个男孩。	我挪我所有个钞票拨了哀个男小囡。
我把我的钥匙留在桌子上面了。你可以把钥匙带给我吗？	我拿我个钥匙留了台子高头了。侬可以帮我拿钥匙带过来伐？
我拥有一匹马。	我拥有一匹马。
我搬在十八层楼，正房跟大厅都面南。	我搬拉十八层楼，正房帮大厅侪朝南。
我收到了一张请帖。	我收到了一张请帖。
我无法区分青蛙和蟾蜍。	我呒没办法区分青蛙跟癞蛤霸。
我无法想象另一个星球上的生物。	我呒没办法想象另一个星球高头个生物。
我早饭吃了馕再喝了茶。	我早饭吃个馕跟茶。
我时间有点来不及，只能出门买大饼油条。	我辰光来大勿及咾，只好出门买大饼油条。
我时间来不及啦，你快一点呀！	我辰光也来勿及唻，侬快点好勿啦！
我明天带给你。	我明朝带拨侬。
我明年想学普通话。	我明年想学普通闲话。
我明年想学汉语。	我明年想学汉语。
我明早八点来接你。	我明朝早浪向八点钟来接侬。
我明白怎么解决问题。	我明白哪能解决问题。
我昨天丢了我的手表。	我昨日挪我个手表落脱了。
我昨晚跟他通电话了。	我昨日跟伊通电话了。
我是1968年在东京诞生的。	我是1968年徕东京出生个。
我是个二流子。	我是个小贪乱。
我是新娘，你是新郎，我们结婚吧!	我是新娘，侬是新郎，阿拉结婚伐!
我是网球俱乐部的会员。	我是网球俱乐部个会员。
我晚点打给你。	我晏眼打畀侬。
我最好要多层房的三四层楼。	我最好要多层房个三四层楼。
我最近戒烟了。	我最近戒烟了。
我有一个兄弟和两个姐妹。	我有一个兄弟跟两个姐妹。
我有一个哥哥,也有一个姐姐。	我有一个阿哥，也有一个阿姐。
我有一个大家庭。	我有一个大家庭。
我有一辆车。	我有一部车子。
我有两个儿子，一个在东京，另一个在名古屋。	我有两个儿子，一个拉海东京，另一个拉海名古屋。
我有两张洗澡票在那儿，今天和我一起去洗澡吗？	我有两张汏浴票子拉海，今朝告我一道去汏浴去𠲎？
我有些东西要给你。	我有点么事要拨侬。
我有些年没见过他了。	我交关年数呒没见过伊了。
我有点儿感动。	我有眼眼感动。
我期待听到你在这件事上的想法 。	我期待听到侬垃海搿桩事体高头个想法。
我来了好长时间了。	我来了交关辰光了。
我来帮你把应用软件干脆统统调掉。	我来帮侬索性拿应用软件统统调脱伊。
我来跟你们介绍一下。	我来帮㑚介绍一下。
我欣赏你。	我欣赏侬。
我正在用电脑。	我垃拉打电脑。
我正在看电视。	我正垃海看电视。
我正在给花浇水。	我垃海帮花浇水。
我每天早上6点叫醒他。	我每天早浪向6点钟叫醒伊。
我每天早晨八点离开家，九点开始工作。	我每日早晨八点钟离开屋里，九点钟开始工作。
我每时每刻都在为你而活。	我每时每刻侪垃海为侬活。
我比你小四个月。	我小侬四个号头。
我比你稍高一点，有没有比这个大一点的尺码？	我比侬长一点点，比搿个尺码大一点个有勿有？
我没什么可依靠的了。	我呒没啥好依靠个了。
我没发现任何我该道歉的理由。	我没发现有啥理由要我道歉。
我没听到您的姓。	我呒没听到侬个姓。
我没有忘。	我呒没忘记。
我没有这本书。	搿本书我呒没。
我没注意。	我呒没注意。
我没见过也没听过这样的事。	我呒没见过也呒没听过搿能个事体。
我没说。	我分讲。
我洗完碗后看了电视。	我汰好碗以后看了电视。
我爱你。	吾爱侬。
我爱你。	我爱侬。
我爱睡懒觉。	我欢喜睏懒觉。
我父亲会游泳但我母亲不会。	阿拉爷会得游泳，但阿拉娘勿会。
我爸爸不喜欢足球。	阿拉爸爸勿欢喜足球。
我爸爸坚持要我去那地方看看。	阿拉爸爸坚持要我去哀个地方看看。
我爸爸对我的爱和照顾不比我妈妈少。	阿拉爸爸对我个爱跟照顾勿比阿拉妈妈少。
我猜想你可能是对的。	我猜想侬可能是对个。
我猜想您喜欢他。	我猜想侬欢喜伊。
我现在30岁了。	我现在30岁了。
我现在不想吃任何东西。	我现在勿想吃啥物事。
我现在不想吃午饭。	我现在勿想吃中饭。
我现在在上班，所以晚点打给你。	我现在垃海上班，所以晏眼打拨侬。
我现在好多了。	我现在好交关了。
我现在很高兴。	我现在老高兴个。
我现在能去了吗？	我现在好去了𠲎？
我理解汤姆的观点。	我晓得汤姆个观念。
我用两千日元买了这本书。	我用两千日元买了搿本书。
我申请了签证。	我申请了签证。
我登上去伦敦的火车。	我乘上了去伦敦个火车。
我百分之百赞成。	我百分之百赞成。
我的一个叔叔给我了一些有用的建议。	我个一个爷叔拨了我一眼有用个建议。
我的信用卡在地铁上被扒了。	我张信用卡垃拉地铁浪向扒脱了。
我的儿子长大了希望做医生。	我个儿子大了希望做医生。
我的地址是武宁路36弄9号底楼。	我个地址是武宁路36弄9号底楼。
我的妻子在试图睡觉。	阿拉老婆垃海试图睏觉。
我的宝宝开始哭了，他想要吃奶。	我个宝宝开始哭了，伊想要吃奶。
我的家乡非常漂亮。	我个家乡邪气漂亮。
我的房子绝对保险。	我个房子绝对保险。
我的房间号是多少？	阿拉个房间号头是多少？
我的手机不见了，怎么办？	我个手机勿见脱了，哪能办？
我的手机找到了，人家打电话来叫我去领了！	我手机找到了，人家打电话来叫我去领了！
我的手被门夹到了。	我个手拨门夹到了。
我的母亲太累了，她早早地去睡了。	我姆妈忒吃力了，伊一早就去困了。
我的生意终于走上了正轨。	我个生意终于走上了正轨。
我的电视机出故障了，所以我不得不拿去修。	我个电视机出故障了，所以我勿得勿拿去修。
我的终生目标是成为一名作家。	我个终生目标是成为一名作家。
我的胆固醇很高。	我个胆固醇老高个。
我的腿还是很痛。	我个腿还是老痛个。
我的责任是什么？	我个责任是啥？
我的钱包被偷了。	我个皮夹子被偷脱了。
我相信他会信守诺言。	我相信伊会得讲言话算数个。
我相信他是老实人。	我相信伊是老实人。
我相信那个故事。	我相信哀个故事。
我看不出有其他方法能让他接受我们的提议。	我看勿出有其他方法能让伊接受阿拉个提议。
我看不懂法语。	我看勿懂法语。
我看你穿稍微淡一点的颜色更加好。	我看侬着稍为淡一点个颜色更加好。
我看见书桌上有朵花。	我看见台子浪向有朵花。
我看见远处有一间小屋。	我看到远处有一间小房子。
我看见远处有一间木屋。	我看到远处有一间木头房子。
我看见那儿有个奇怪的女人。	我看到哀搭有个奇怪个女人。
我看这条倒挺大方的。	我看搿条倒蛮大方。
我真的很抱歉，我好像弄丢了你的雨伞。	我真个老勿好意思个，我好像拿侬个洋伞弄落脱了。
我穿好衣服以后就吃早饭。	我穿好衣裳以后就吃早饭。
我经常打嗝。	我经常打餩。
我给他们一份。	我拨伊拉一份。
我肯定他会成功的。	我肯定伊会得成功个。
我肯定你会喜欢我们今晚的菜肴。	我肯定侬会得欢喜阿拉今朝夜到个菜肆个。
我肯定忘了带雨伞，但现在已经太迟了。	我肯定忘记了带洋伞，但现在已经忒晏了。
我能借一下您的自行车吗？	我好借用一下侬个脚踏车伐？
我能关电视吗？	我好关电视𠲎？
我能和你谈谈吗？	我好脱侬谈谈伐？
我能用一下你的铅笔吗？	我好用一下侬个铅笔𠲎？
我自己一个人做的。	我自家一家头做个。
我花了3小时做作业。	我花了三个钟头做功课。
我表妹半年前生小孩生了个大胖儿子。	阿拉表妹半年前养小囡养了一个大胖儿子。
我被一辆车超了。	我被一部车子超过了。
我要一杯冰红茶。	我要一杯冰红茶。
我要去超市，快餐面啊，酒酿团子啊，一样一样买回来。	我要到超市去，熟泡面啊，酒酿圆子啊，一样一样买回来。
我要吃本地菜，浓油赤酱的栗子红烧肉。	我要吃本邦菜，栗子红烧肉，浓油赤酱个。
我要吃鱼和海鲜。	我要吃鱼跟海鲜。
我要和张先生、李先生谈谈。	我要告张先生、李先生谈谈。
我要回房间了，在那儿我可以学习。	我要回房间了，垃海哀搭我可以学习。
我要寄钱给我母亲，给我一张寄款单好吗？	我要寄钞票拨姆妈，拨一张寄款单拨我好𠲎？
我要打给我女儿一个电话。	我要打一只电话拨我囡儿。
我要报考你们的职业培训班，哪天考试？	我要报考㑚个职业培训班，啥辰光考试？
我要睡到八点半才起身。	我要睏到八点半刚刚起来。
我要送到上海文艺出版社。	我要送到上海文艺出版社。
我要预订一间6月3日的单人房。	我要预订一间6月3号个单人房。
我觉得价钱太贵，再说没什么特别好看……	我觉着价钿忒贵，再讲呒没啥特别好看……
我觉得你太过分了。	我觉着侬忒过分了。
我觉得你太过分了。	我觉着侬走过头了。
我觉得你的回答是正确的。	我觉得侬个回答是正确个。
我觉得你的工作可以。	我觉着侬个工作可以。
我觉得你说的是真的。	我觉着侬讲个是真个。
我觉得很热。	我觉着老热个。
我觉得这个网站的构思非常好。	我觉着搿个网站个构思邪气好。
我觉得这个网站的概念非常好。	我觉着搿个网站个概念邪气好。
我觉得这本书很有意思。	我觉着搿本书老有劲个。
我觉得这种事情偶然发生。	我觉着难得出搿重事体个。
我认为是一幅毕加索的原画。	我认为是一幅毕加索个原画。
我认识史密斯先生有好多年了。	我认得史密斯先生有得交关年数了。
我认识她两年了。	我认得伊两年了。
我讨厌别人让我等很久。	我讨厌人家让我等交关辰光。
我让他打扫了我的房间。	我让伊打扫了我个房间。
我让他扫地了。	我让伊拿地扫脱了。
我让她等了一分钟。	我让伊等了一分钟。
我该做什么？	我该做啥？
我该去睡觉了。	吾要去困觉了。
我该取消通话吗?	我该取消通话𠲎？
我请您原谅我。	我请侬原谅我。
我谢谢你帮帮忙，给我把灯关了，我想睡觉了。	我谢谢侬帮帮忙，脱我灯关关脱，我想睏觉了。
我赚钱养家。	我赚钞票养屋里。
我跑得尽可能快。	我跑了尽可能个快。
我还不知道你是那么好厨师。	我倒勿晓得侬是介好个厨师。
我还了从图书馆借的书，又借了些新的。	我还了从图书馆借个书，又借了眼新个。
我还常常看上海滑稽，或者全家围着电视机看足球。	我还常庄看上海滑稽，或者一家门围牢仔电视机看足球。
我还是对豫园、城隍庙、上海老街更加有兴趣，想拍两张照片。	我还是对豫园、城隍庙、上海老街更加有兴趣，想拍两张照片。
我还没吃。	我还呒没吃过。
我还要焗油和吹风。	我还要焗油咾吹风。
我这周很忙。	我搿周老忙个。
我这是统货，你要挑的话，就只能卖十元五斤。	我是统货，侬要拣末，就只好十元五斤。
我送了他一个在美国买的双火焰的打火机。	我送了一个拉垃美国买个双火焰个打火机拨伊。
我通常8点钟起来。	我通常8点钟起来。
我逼他说出了真相。	我逼伊讲出了真相。
我难以用言语表达我的感情。	我老难用语言表达我个感情。
我需要一双新鞋。	我需要一双新鞋子。
我需要十号大小的鞋子！	我需要十号大小个鞋子！
我需要购买新的镜架。	我需要买新个镜框。
我非常想见到他。	我非常想见到伊。
所有你该做的就是尽你的全力。	所有侬该做个就是尽侬个全力。
所有女人都该让她的丈夫戴绿帽子。	所有个女人侪应该让伊个老公戴绿帽子。
所有学生都可以自由出入图书馆。	所有学生侪可以自由出入博物馆。
所有被发明的都是真的。	所有被发明个侪是真个。
打网球是他的兴趣。	打网球是伊个兴趣。
托尼的英语和你说得一样好。	托尼个英文讲了跟侬一样好。
把他放进去。	拿伊放进去。
把勺子给我。	挪钞拿拨我。
把探测机拿来一起去草原里。	拿探测机挪得来一道到草原里去。
把架子上的灰尘擦一下。	架子高头灰尘揩一揩。
把脏衣服拿去洗一洗！	龌龊衣裳去汏汏伊！
把这条阴沟通好！	搿条阴沟通好伊！
把门开开！	门开一开！
把问题澄清一下。	挪问题澄清一下。
护士会告诉你怎么做。	护士会告诉侬哪能做。
拿好发票，别把东西忘在车上。	发票拿好，物事勿要忘记拉车子高头。
按原样儿吧，稍微短一点。	照老样子好了，稍为短一点。
挑一家好吃点的饭店去吃。	拣爿好吃点个饭店去吃。
挤的地方保持安静依次排队。	轧个地方保持安静依次排队。
挺好，挺好，下一次再花点儿功夫就成功了。	蛮好，蛮好，下一趟再花点功夫就成功了。
据说他爸爸在外国去世了。	据讲伊拉爷垃海外国走脱了。
据说山上的天气变化很快。	据讲山浪向个天气变化老快个。
据说日本人对他们认识的人非常友好，对不认识的人非常冷淡。	据讲日本人对伊拉认识个人非常友好，对勿认识个人非常冷淡。
接下来该采取什么行动就交给你了。	接下来该采取啥个行动就交拨侬了。
接受对方的准则就是给予他权力。	接受对方个准则就是拨伊权力。
接电话。	接电话。
控制一个班级需要你做老师的所有技能。	控制一个班级需要侬做老师个所有技能。
插进去，看它的说明就是了。	插进去，看伊说明打就是了。
搞条活杀大黄蛇吃好吗？	弄条活杀大黄蛇吃吃好𠲎？
搿只箱子要特别脱我当心，因为里向是陶器咾瓷器，还有镜框咾啥。	搿只箱子要特别脱我当心，因为里向是陶器咾瓷器，还有镜框咾啥。
收音机的声音有点响。	无线电个声音有点响。
放开我，你正在掐着我的脖子。	放脱我，侬垃海掐牢我个头颈。
教育的最终目的是什么？	教育个最终目的是啥？
数据表明年轻人抽烟的现象没有减少。	数据表明年轻人吃香烟个现象呒没减少。
整个夏天，我们在那里过得很愉快。	整个夏天，阿拉拉海哀搭过了老愉快个。
新年快乐！	新年快乐!
新条约可能在接下来的两三周内谈妥。	新个条约可能垃海接下来个两三个礼拜之内谈拢。
新酷一族派对在茶吧里开，四个人边吹牛，边打扑克开玩笑，过把瘾就散。	新酷一族派对垃拉茶吧里开，四个人牛皮吹吹，打打扑克打打朋，过把瘾就散。
旁边一排衣服跟这里的衣服没什么不一样。	旁边一排衣裳告搿搭个衣裳呒没啥两样。
旅行最快的方式是乘飞机。	旅游最快个方式是乘飞机。
无论你要我做什么，我都会去做的。	勿管侬要我做啥，我侪会去做个。
无风不起浪。	无风不起浪。
既然你这么喜欢种花，你把一个阳台就专门放花盆吧。	既然侬介欢喜种花，侬一只阳台就专门摆花盆好唻。
既然房间里新家具都买好了，这点破家具都可以丢掉了！	房间新家生侪买好了末，搿点破家生侪可以厾脱了！
既要马好，又要马不吃草。	既要马好，又要马勿吃草。
日本人放弃了战争。	日本人放弃了战争。
日本的人口比英国多。	日本个人口比英国多。
日本的首都是东京。	日本个首都是东京。
旧杂志卖完了。	旧杂志卖光了。
旧的不去新的不来。	旧个勿去新个勿来。
早些年买的那个脱排油烟机过时了，所以我要换掉一个。	早两年买个搿只脱排油烟机过时了，葛咾我要换脱一只。
时间快要到了，你怎么还拖啊拖的。	辰光要到快了，侬哪能还捱发捱发。
时间还早着呢，大家坐下来侃一会儿吧。	辰光还早拉海唻，大家坐下来嘎嘎山河𠲎。
明天下午之前我会把它完成。	明朝下半天之前我会得拿伊完成。
明天中午叫他打给我一个电话。	明朝中浪向叫伊打拨我一只电话。
明天他会来吗？	明朝伊会得来𠲎？
明天会下雨吗？	明朝会落雨𠲎？
明天你九点钟要来这里的。	明朝侬九点钟要到搿搭来个。
明天天气会好吗？	明朝天气会好𠲎？
明早九点给我打电话。	明朝九点钟帮我打电话。
春去夏来。	春去夏来。
昨天在餐馆里点了一盘京都排骨，一份铁板茄子，一份香苏鸭子，一盘八珍豆腐宝，一盘空心菜和两碗白饭，我们被喂饱了。	昨日拉垃餐馆里点了一盘京都排骨，一份铁板茄子，一份香苏鸭子，一盘八珍豆腐宝，一盘蓊菜跟两碗白饭，挪阿拉饫饱了。
昨天天气太好了，所以我们决定自己开车出去的。	昨天天气忒好了，所以阿拉决定自家开车出去个。
昨天我快出门的时候，他倒摇啊摇的来了。	昨日我要出门快个辰光，伊倒一摇一摇个来了。
昨天是我17岁生日。	昨日是我17岁生日。
是不是装修好的？	是勿是装修好个？
是啊，年纪不饶人，今年四十二了。	是呀，年纪勿饶人，今年四十二岁了。
是它的两倍大。	是伊个两倍大。
是的，我马上来。	是个，我马上来。
是这样的。	是搿能个。
是长风饭店吗？请转328分机。	长风饭店是𠲎？请转328分机。
晚饭后，我总想睡觉。	夜饭以后，我老是想困觉。
晚饭还没有好，要到六点三刻开饭。	夜饭还呒没好，要到六点三刻开。
暴风雨会持续多久？	暴风雨会持续多长辰光？
最后一次请你啦，你要认真负责点替我做好！	辣末一趟请侬唻，侬要脱我顶真点做做好！
最有名的是在太平桥绿地中打造了一个“新天地”。	名气最响个是拉太平桥绿地当中打造了个“新天地”。
最近三个月，价钱涨高了。	最近三个月，涨价了。
最近的火车站在哪里？	最近个火车站垃拉阿里搭？
最近的火车站在哪里？	最近個火車站垃壗嚡裡墶？
月球是地球唯一的卫星。	月球是地球唯一个卫星。
有了坚定的目标，你会做得很好。	有了坚定个目标，侬会得做了老好个。
有效期到1997年3月31日为止。	有效期到1997年3月31号为止。
有时候不知道的。	有常子勿晓得个。
有时候我不懂他的意思。	有辰光我勿懂伊个意思。
有时候是边逛边看，领略市场信息，饱眼福。	有常时是荡荡看看，领领市面，饱饱眼福。
有没有煤气热水器、洗衣机、空调？	煤气热水器、洗衣机、空调有勿有？
有点什么公共设施？	公共设施有眼啥？
有点恶心，但是吐不出来。	有点恶心，但是吐勿出来。
有爱情必有妒忌。	有爱情必有妒忌性。
有网络作家说写作计划，也有小企业家谈种种发家奇遇。	有网络作家讲写作计划，也有小企业家谈种种发家奇遇。
朋友之间，大家谈谈心，非常爽快。	朋友淘里，大家谈谈心，老爽个。
朝南窗口前面还会造高楼，挡住阳光跟视线吗？	朝南窗口前面还会造高楼，档牢阳光帮视线𠲎？
来吧，我帮你盛。	来𠲎，我帮侬盛。
桥在建造中。	桥垃海造。
欢迎光临，小姐今天要剪发还是烫发？	欢迎光临，小姐今朝头发要剪一剪还是烫一烫？
欢迎光临，现在人很多，请坐下来等一等。	谢谢光临，现在人多，请侬坐下来等一等。
正当他要出门的时候，开始地震了。	正当伊要出门个辰光，开始地震了。
母亲很担心孩子。	母亲老担心小人个。
每月六百元，每周一天休息，行吗？	每月六百元，每周一天休息，可以𠲎？
每月发工资的那天，我给我妈5000日元。	每个号头发工资个哀天，我拨阿拉姆妈5000日元。
每次我完成一项工作，我就在列表上确认一下。	每次我完成一项工作，我就垃海列表高头确认一下。
比如说，小区健身房、儿童乐园、图书馆等有吗？	譬如讲，小区健身房、儿童乐园、图书馆咾啥有𠲎？
比起淡咖啡，我更喜欢浓咖啡。	比起淡咖啡，我更欢喜浓咖啡。
毛坯房，现在正在请人装修。	毛坯房，现在正垃拉请人装修。
气气闷闷生大病，嘻嘻哈哈添寿命。	气气闷闷生毛病，嘻嘻哈哈添寿命。
水快开了，泡杯茶喝了再走。	水开快唻，泡杯茶吃了再走。
水沸腾后变为蒸汽。	水沸腾以后变成蒸汽。
江山易改，本性难移。	山水好移，本性难改。
江边有条支河，叫“上海浦”，就是现在黄浦江的一段。	江边有条支河，叫“上海浦”，就是现在黄浦江个一段。
汤姆星期一来的，第二天返回了。	汤姆礼拜一来个，第二天回去了。
没事儿。	勿要紧个！
没人知道那机器长什么样子。	呒没人晓得哀个机器长啥个样子。
没什么好招待你的。	呒没啥好招待个。
没关系！	勿搭界个！
没关系，当然最好还是买本会话书学学上海话。	勿要紧个，当然最好还是买本会话书学学上海话。
没关系，送你到电梯口。	勿要紧个，送侬到电梯口。
没关系，随便哪块。	呒没关系，随便阿里一块。
没有人能搬得动那个大箱子。	呒没人能搬得动哀只大箱子。
没有人跑在他前面。	呒没人跑拉伊前头。
没有水，我们无法生存。	呒没水，阿拉呒没办法生存。
油墨快没了。	油墨快呒没了。
沿着这条街直走。	沿牢搿条街直走。
沿着这条路直走，到第三个红绿灯的地方右转。	沿牢搿条路直走，到第三个红绿灯个地方右转。
法兰克高兴地等待着他晚上的约会。	法兰克高兴个等了海伊夜到个约会。
法国人是我们的朋友。	法国人是阿拉个朋友。
法语中包含了很多近义词。	法语中包含了交关近义词。
波兰与乌克兰两国一起举办2012年欧洲足球锦标赛。	波兰跟乌克兰两国一道举办2012年欧洲足球锦标赛。
洗什么澡？桑拿浴我是怕闷死的，要不就泡大池。	汏啥个浴？桑拿浴我是怕闷煞脱个，要末就大汤泡泡。
洗你的脚。	汰侬个脚。
洗您的脚。	汰侬个脚。
洗手间在哪里？	汏手间勒勒阿里耷？
活期取款的话，你可以随便什么时候用硬卡刷。	活期取款末，侬可以随便啥辰光用硬卡拉。
派对延期了一周。	派对延后了一个礼拜。
浴室干净吗？	浴室干净伐？
浴室干净吗？	浴间里清爽伐？
海滩上你到底愿意去吗？	海滩高头侬到底高兴去𠲎？
海王星是太阳系第八个行星。	海王星是太阳系个第八个行星。
消防车到达之前，房子就全烧了。	消防车到之前，房子就侪烧脱了。
淮海路的商品高雅前卫，有海派特色。	淮海路个商品高雅前卫，有海派特色。
深藏青比不上黑颜色好看，是不是？	深藏青阿是及勿上黑颜色好看？
温度计往往低于零度。	温度计往往低于零度。
火腿要隔水“蒸”，牛百叶只要水里一“汆”。	火腿要隔水“蒸”，牛百叶只要水里一“汆”。
火车因大雪被耽搁了。	火车因为大雪被耽搁脱了。
火车马上就要开，我们勉强可以赶到。	火车马上就要开，阿拉勉强可以赶到。
灯里的油用完了。	灯离里向个油用光了。
点这些小菜行啦！够吃了！	点搿眼小菜好唻！有得吃唻！
烦不烦人呀！	啊是烦来死个！
烧的时候加黄酒把腥味去掉。	垃海烧个辰光，加黄酒拿腥气戒脱伊。
烹调方法也又是精致又集江南大成。	烹调方法也又是精致又集江南大成。
煤气不一定要独用，但是卫生要独用。	煤气勿一定要独用，但是卫生要独用个。
照相，不过是我的一项业余爱好。	拍照相，只勿过是我一项业余爱好。
照这样的情况，很抱歉，我不能接受你的盛情邀请。	照搿能个情况，老抱歉个，我勿能接受侬个盛情邀请。
父亲和儿子在一起，真温馨啊。	爷帮儿子一道垃海，真焐心啊。
牧场的面积有10英亩。	牧场个面积有10英亩。
“牵头皮”、“收骨头”、“戳壁脚”、“插外快”，惯用语多而幽默。	“牵头皮”、“收骨头”、“戳壁脚”、“插外快”，惯用语多而幽默。
狗的嗅觉灵敏。	狗个嗅觉灵敏。
狗追猫，猫追鼠。	狗追猫，猫追老鼠。
猪蹄煮得酥一点，知道吗？	蹄膀笃得酥一点，鞋！
猫抓住了老鼠。	猫抓牢了老鼠。
王兄，你现在在做什么生意了？	王兄，侬现在垃拉跑啥个生意？
王子继承了王位。	王子继承了王位。
王小明和旺月两个人都是我的好朋友。	王小明跟旺月两个人侪是我个好朋友。
王阿姨，是我来啦。	王阿姨，是我来了。
玩得开心点！	白相了开心点！
环境卫生人人珍视。	环境卫生人人珍视。
现代年轻人戴风帽是装一种派头。	现代年级轻个人戴风帽是拜种派头。
现在他做什么？	现在伊垃海做啥？
现在休息一下。	现在休息一下。
现在你开始热起来了。	现在侬开始热起来了。
现在已经收场了，不知道还能找到吗？	乃已经收场了，勿晓得还寻得着𠲎了？
现在我们差不多有同样的水平了，我们可以开始学习几段四手联弹。	现在阿拉差勿多有同样个水平了，阿拉可以开始学习几段四手联弹了。
现在我可以走了吗？	现在我可以走了𠲎？
现在是看樱桃树的期间。	现在是看樱桃树个日节。
现在热闹的地方，夜市也好得盖了帽。	现在热闹个地方，夜市面也好得一塌糊涂。
现在的老师么，非常迷信考试，据说今天又要考试啦。	现在老师对𠲎，邪气迷信考试，今朝又要考试了喔伊讲。
现在走吧。	现在走𠲎。
现在铂金首饰非常热。	现在铂金首饰邪气热门。
生日快乐！	生日快乐!
生活要做细，吃饭要吃粗，三餐不吃多。	生活要做细，吃饭要吃粗，三餐勿吃多。
用尺来划直线很方便。	用尺来划直线老方便个。
用鼻子顶住一个球很困难。	用鼻头顶牢一个球老难个。
由于产量过剩，卷心菜的价格下降了。	由于产量过剩，卷心菜个价钿下来了。
由于火车延误，我迟到了。	由于火车脱班，我迟到了。
由医生来决定某人何时该死是对的吗？	由医生来决定一个人啥辰光死是对个吗？
电影快要开演了。	电影快要开演了。
电视在日常生活中起着重要的作用。	电视垃海日常生活中起了重要个作用。
电视的优点在于它给体育爱好者提供了更大的方便。	电视个优点垃海伊帮体育爱好者提供了更加大个方便。
男孩睡了10小时。	男小囡困了10个钟头。
病人随时会死。	病人随时会走。
痛了几天了？你从前有胃病吗？	痛了几日了？侬老早胃病有𠲎？
痛过，但是没现在这么厉害。	痛是痛过歇个，呒没现在介厉害。
盘子在哪里？	盘子垃啊里嗒？
目前，我妹妹在一家超市当收银员。	目前，阿拉阿妹垃海一家超市当收银员。
“直快”车票没有了，“特快”还有。	“直快”车票呒没了，“特快”还有。
看见新鲜龙虾，我有了食欲。	看见新鲜龙虾，我有了食欲。
看起来这都是天书。	看上去搿眼侪像天书咖。
看，足球踢得正紧张呢。	喏，足球踢得正好紧张拉海。
看，这是我的名片。	喏，搿个是我个名片。
真叫做看人挑担不吃力，我和你换一换好吗？	真叫看人挑担勿吃力，我脱侬调一调好𠲎？
真的希望他们做夫妻白头偕劳。	真个希望伊拉做夫妻白头到劳。
真相的本义会让人不快。	真相个本义会得让人勿爽。
着火了！快跑啊！	着火了！快跑啊！
睡眠是最大的小偷，它偷了我们一半的生命。	睡眠是最大个贼骨头，伊偷了阿拉一半个生命。
睡过头不是迟到的理由。	困过头勿是迟到个理由。
知足常乐。	知足常乐。
离这里不远。	搿搭到哀面是老近个。
科学和数学我都喜欢。	科学跟数学我侪欢喜。
稍微等一下，现在说得很多了。	稍等，现在讲的啥？
站在窗口的那个人是你们经理吗？	立拉窗口头个搿个人是㑚经理，对𠲎？
第一班火车什么时候出发？	第一班火车啥辰光出发？
等她回来的时候问问她。	等伊回来个辰光问问伊。
签证到现在还没拿到，我真快急死了！	签证到现在还呒没拿到，我真是急煞快！
简而言之，我不同意。	简单点讲，我勿同意。
系上鞋带。	擘上鞋带。
红色不流行了。	红颜色勿行了。
约翰·列侬是1940年出生的。	约翰·列侬是1940年出生个。
纽约市的人口有多少？	纽约市个人口有得多少？
终于！	终算！
经过银行，左边就是他的办公室了。	经过银行，左边就是伊个办公室了。
给你三楼三零五房间好吗？	拨侬三楼三零五房间好𠲎？
给你添麻烦啦！	帮侬添麻烦啦！
给我一张白纸。	拨我一张白纸。
给我一点儿。	拨我一点。
给我个例子。	拨我个例子。
给我订一张“特快”车票。	告我定一张“特快”车票。
给，给你！	喏，拨侬！
绿地中，假山啊，瀑布啊，湖泊啊，田园风光啊，什么都有。	绿地当中，假山咾，瀑布咾，湖泊咾，田园风光咾，样样侪有。
绿灯时，拐弯车要让人。	绿灯辰光，转弯车子要让人。
罗杰斯先生和史密斯小姐昨天宣布订婚。	罗杰斯先生跟史密斯小姐昨日宣布订婚。
罗马不是一天建成的。	罗马勿是一天造好个。
“美丽园”站到了没有？	“美丽园”站头到了𠲎？
美国人对威驰失去了信心。	美国人对威驰失去了信心。
翻译正在试图给尽可能多的细节和消息。	翻译垃海试图拨尽可能多个细节跟消息。
“老上海”派对里，几个老克拉不但唱起评弹沪剧，卡拉OK也很精通。	“老上海”派对里，几个老克拉勿但唱起评弹申曲，卡拉OK也邪气懂经。
老克拉讲，管它什么时候什么时尚，你一直要够in，一定不能out。	老克拉讲，勿管伊啥辰光啥时尚，侬一直要够in，一定勿好out。
老哥真有能耐！哪像我呆在半死不活个单位里头。	老兄有噱头个！勿像我死样怪气个单位里捂拉海。
老实说，我不喜欢他。	老实讲，我勿欢喜伊。
老实说，这部小说不太有意思。	老实讲，搿部小说勿大有意思。
老师没收了一个学生的手机，因为他在课上发短信。	老师没收了一个学生个手机，因为伊垃海课堂浪向发短信。
肏你妈屄！	肏㑚！
胡锦涛的生日谁知道啊？	胡锦涛个生日啥人晓得喂？
胸口有点儿疼，所以吃不下饭。	心口头有眼痛咾，饭吃勿落。
能不能麻烦你告诉我去邻村怎么走？	能勿能麻烦侬告诉我去邻村哪能走？
能听懂一点儿，但是不会讲。	听是听得懂一眼眼，讲讲勿来个。
能者多劳。	能者多劳。
能说给我听你的地址吗？	侬个地址讲拨我听好𠲎？
能请您写一下吗？	能请侬写下来𠲎？
脚一长之后，就显得很苗条，摆起架势来棒极了！	脚一长了末，就显得苗条得来，摆起poss来末一级！
自己动手真好。	自家动手真好。
自行车从右侧超过汽车是不合法的。	脚踏车从右侧超过汽车是勿合法个。
舅舅那儿好久不去了，他常常一个人在家太寂寞。	娘舅拉长远勿去了，伊常常一家头拉屋里忒厌气。
舞台上有著名音乐家吗？	舞台高头有得著名音乐家𠲎？
花园被木栅栏围了起来。	花园被木栅栏围起来了。
苹果作为甜点供应。	苹果作为甜点供应。
茭白用油“焖”，蛤蜊放在蛋里“炖”。	茭白用油“焖”，蛤蜊摆拉蛋里“炖”。
茶叶是从中国传入的。	茶叶是从中国传入个。
茶壶里再冲点水在里面。	茶壶里再冲点水拉海。
荷兰豆盖了帽了！	荷兰豆女赞得勿得了！
菜碗放得满桌都是，连吃剩下来的肉汤也没收拾好。	小菜摊了一台子，吃剩拉海个肉汤都呒没收好。
萝卜青菜各有所爱。	萝卜青菜，个人心爱。
虽然时髦一点，但是价钱太大！	时髦是时髦一点了，价钿忒大！
行了！就十元买五斤吧。	好了好了！就十元五斤𠲎。
行。你这儿有几种款式，给我看看。	好个。㑚搭有几种款式，拨我看看叫。
行。唱个什么？	好个。唱只啥？
补药虽然好，不过药补不如食补。	补药好是好，不过药补勿如食补。
被挑出来的孛荠怎么煮着吃？	撩出来个甜莲哪能吤烧来吃？
要不寄“特快邮件”明天就可以到。	要末寄“特快邮件”明朝就可以到。
要不我们到别的地方再去看看。	要末阿拉到别个地方再去看看。
要做怪事必须有两个人才行。	要做怪事体必须得有两个人才可以。
要变得完美，她就是少了一个缺点。	要变得十全十美，伊就是少了一个缺点。
要学三个号头，全部用业余时间。	要学三个号头，全部用业余辰光。
要完成实验，三个月太短了。	要完成实验，三个号头太短了。
要成功，还要有各种素质，像创造力啊，坚持性啊，独立意识啊，组织能力等等。	要成功，还要有各种素质，像创造力啊，坚持性啊，独立意识啊，组织能力咾啥。
要掌握法语一点都不容易。	要掌握法语一眼也勿容易。
要是我说错话被人议论，我是不管的。	要是我错脱个闲话被人家评论，我勿管个。
要是搬不动，就多叫几个人来搬。	搬勿动末，多叫几个人来搬。
要考什么内容？有参考书吗？	啥个内容要考？参考书有𠲎？
认识你们，我很高兴。	认得㑚，我老高兴个。
让我们先看一下再说。	让阿拉先看看再讲。
让我们别来，我们就更想来了。	让阿拉勿要来，阿拉就更加想来了。
让我们来澄清一下这个问题。	让阿拉来澄清一下搿个问题。
让我进去。	让我进去。
让标准路标和规范文字说话。	让标准路标跟规范文字讲话。
让窗子关着。	让窗子开垃海。
让门关着。	让门关垃海。
让门锁着。	让门锁垃海。
讲英语的时候不要怕会不会说错什么。	讲英语个辰光勿要怕会勿会讲错啥。
讲西班牙语的人习惯把一种仙人掌叫做 「继母的垫子」 。	讲西班牙文个人习惯拿一种仙人掌叫做 「继母个垫子」 。
许多人在工业城市工作。	交关人垃海工业城市工作。
许多国家的代表出席了会议。	交关国家个代表出席了会议。
许多工人死于饥饿。	交关工人饿死脱了。
许多燕子不久就要从南方飞来了。	交关燕子老快就要从南方飞过来了。
许多词是根据拼写来发音的，不过有些不是。	交关词是根据拼音来发音个，不过有眼勿是。
证婚人致贺词，双方互赠结婚戒指。	证婚人致贺词，双方互赠结婚戒指。
试衣室正在占用着。	试衣室占用垃海。
诚信是一种重要的美德。	诚信是一种重要个美德。
该死的！你吓死我了！	杀千刀！侬吓了我一大跳！
说和做是两码事。	讲跟做是两回事体。
请不要忘记寄信。	请勿要忘记寄信。
请仔细洗牌。	请㑚仔细弹牌。
请你从这儿走，那儿是检查台，检查行李的地方。	请侬从搿搭走，哀面是检查台，检查行李个地方。
请你们快点来一辆救护车，快！	请㑚快点来部救护车，豪燥！
请你告诉李民先生，说我十点钟打过一个电话给他的。	请侬告诉李民先生，讲我十点钟打过一只电话拨伊个。
请你帮我在这张纸上画个草图。	谢谢侬帮我搿张纸头浪向画个草图。
请你帮我换一点零钱行吗？	请侬帮我换一点零碎钞票好𠲎？
请你把冷气调高点。	请侬挪冷气调高眼。
请你把护照出示给我看看，还有入境表格填好了吗？	请侬拿护照出示拨我看看，还有入境表格填好𠲎？
请你把这张表填一下，等我们的通知。	请侬搿张表填一填，等阿拉个通知。
请你把这张表格填好，考试就在这个月二十号。	请侬拿搿张表格填好，考试就拉搿个月廿号。
请你来帮我看看，抽水马桶坏了。	请侬来帮我看看，抽水马桶坏脱了。
请你给我指点一下。	谢谢侬帮我指点一下。
请你让我一下好吗？	谢谢侬让一让我好𠲎？
请别在这里拍照。	请勿要垃海搿搭拍照。
请去希尔顿酒店。	请去希尔顿酒店。
请向前一步。	请朝前一步。
请安静一点！	静一点好𠲎！
请帮我找一下我的钱包。	请帮我寻一下我个皮夹子。
请我们去饭店吃晚饭。	请阿拉到饭店去吃夜饭。
请把你们的全盘计划告诉我。	请挪㑚个全盘计划告诉我。
请把你的行李放在这秤上。	请拿侬个行李摆了搿秤高头。
请把姓名和地址告诉我。	请挪姓名跟地址告诉我。
请把它充入我的账户。	请拿伊充到我个账户里向去。
请把水瓶灌满。	谢谢侬拿水瓶灌满。
请把盐和胡椒粉拿给我。	请拿盐跟胡椒粉拨我。
请等5分钟。	请等5分钟。
请简述你的想法。	请简单讲讲侬个想法。
请简述您的想法。	请简单讲讲侬个想法。
请给我看看您的护照。	请拨我看看侬个护照。
请问你们几位是美国贸易代表团的吗？	请问㑚几位是美国贸易代表团个𠲎？
请问你贵姓？	请问侬贵姓？
请问到南京西路怎么走近一点？	对勿起到南京西路哪能走近一点？
请问去大世界怎么走？	请问到大世界去哪能走？
请问您要点儿甜味酱。	请问㑚要眼甜味酱。
请问新桥饭店离这儿远不远？	请问侬新桥饭店离搿搭远勿远？
请问最后一次开信箱在什么时间？	请问辣末一趟开信箱拉啥辰光？
请问河南中路五十二弄在什么地方？	谢谢侬河南中路五十二弄垃拉阿里搭？
请问，现在什么时候？	对勿起，现在啥辰光了？
请问，这位女士是什么人？	请问，搿位女士是啥人？
请问这儿是什么地方？	谢谢侬搿搭是啥地方？
请问这条路是什么路？	勿好意思搿条路是啥个路？
请随您的便叫我一声。	请侬随便叫我一声。
读尽可能多的书。	读尽可能多个书。
读这种的书有什么用？	读搿种书有啥个用？
谁把所有的曲奇都吃了？	啥人挪所有个曲奇侪吃脱了？
谁教你们法语？	啥人教㑚法语？
谁来为风险投资提供资金？	啥人来帮风险投资提供资金？
谁种了这棵树？	啥人种了个棵树？
"谢谢。" "不用谢。"	"谢暇侬。" "覅暇。"
谢谢你的答复。	谢谢侬个答复。
谢谢，没时间了，我只要揉揉背和腰就好。	谢谢，呒没辰光了，我只要捏捏背跟腰好了。
谣言可能是真的吗？	谣言可能是真个𠲎？
走到那边一条小弄堂向左拐弯。	跑到搿面一条小弄堂左转弯。
走啊！大家可以开始走了！	走呀！大家走起来！
走过去一点！	走过去一眼！
跟其它的比，法国护照有多难看啊。	跟其它比，法国护照多少难看垃海。
跟我来！	跟我来！
跟我说说你的计划。	脱我讲讲侬个计划。
路中间有一辆卡车。	路当中有一部卡车。
路边装了许多雷达。	路边装了交关雷达。
跳得尽可能高。	跳了尽可能高。
身份证你带来吗？	侬身份证带来𠲎？
身份证号码我已经填在那儿了，可以领吗？	身份证号码我已经填拉海了，可以领𠲎？
身体好了，人很带劲；如果不好，什么事也不想做。	身体好末，人老起劲；勿好末，啥事体也勿想做。
车厢里只报站名不要啰嗦。	车厢里向只报站名勿要啰囌。
车行道滑的。	车行道滑个。
车！	车子！
轮到我了吗？	轮到我了，是𠲎？
软卧票还有吗？	软卧票还有𠲎？
轻一点儿放！	轻轻叫放！
过了二十二岁，一个人不会说六种语言就算一生失败了。	过了廿二岁，一个人勿会得讲六种语言么相当于一生失败了。
过去心脏从来没有发现有病，所以这次有点措手勿及。	过去心脏从来呒没发现毛病，所以搿趟有眼措手勿及。
过去,我是中学生,现在我是大学生.	老早，我是中学生，现在我是大学生。
还有两站下去。	还有两站下去。
还有二十分钟，时间很充裕。	还有廿分钟，辰光老宽舒个。
还有件事就是马上到银行里去取些钱。	一桩事体是马上到银行里去拿眼钞票。
还有那边柜台里也有很多呢。	还有哀面柜台里向也有交关垃海。
还要一点儿。	还要一眼眼。
还要多少？	还要多少？
还谢什么呀！甭谢，没关系的。	谢啥！勿要谢，呒没关系个。
这一阵我很忙！	搿抢里我老忙个！
这下搞得你今天累死了！	乃弄得侬今朝吃力煞了！
这不是一个漏洞，而是一个没有写进文档的特性。	搿勿是一个漏洞，而是一个呒没写进文档个特性。
这不是你的书,这是我的书。	搿勿是侬个书，搿是我个书。
这个东西是你的吗？	搿个物事侬个是𠲎？
这个人是谁？	哀个人是啥人？
这个只有奥巴马知道了。	迪个只有奥巴马晓得个。
这个国家的政府压迫人民。	搿个国家个政府圧迫人民。
这个图书馆里禁止看书。	搿个图书馆里禁止看书。
这个城市的交通方便得很。	搿个城市个交通老方便个。
这个工作不适合年轻女孩。	搿个工作勿适合年轻个小姑娘。
这个房子属于谁？	搿个房子属于啥人个？
这个房间里有个电视机。	搿个房间里向有个电视机。
这个月底前，我们必须交报告。	搿个月底前，阿拉必须得交报告。
这个班有15个男生和28个女生。	搿个班有15个男生跟28个女生。
这个班有多少男生？	搿个班有得多少男生？
这个节日是在秋分时候庆祝的。	搿节日是垃秋分辰光庆祝个。
这个问题不能以常规方法解决。	搿个问题勿能以常规办法解决。
这个问题再度出现。	搿个问题再度出现。
这么贵！能便宜些吗？	介贵个！可以便宜点𠲎？
这些天下了好多雪。	搿些日节落了交关雪。
这些是我们的书。	搿眼是阿拉个书。
这些是谁的书？	搿眼是啥人个书？
这些破烂，你还不丢了？	搿眼破唠嘈，侬还勿掼脱伊啊？
“这些车是你的吗？”“是的，是我的。”	“搿眼车是侬个𠲎？”“是个，是我个。”
这些都是很早的故事了。	迪个侪是老哩百早个故事。
这些食物看起来很好吃。	搿眼物事看起来老好吃个。
这以后，对身体千万不可大意，免得大家挂念。	乃以后，对身体千万大意勿得，省得大家牵记。
这以后要经常锻炼，我买了点补药给你吃吃看。	乃要经常锻炼锻炼。我买了点补药侬吃吃看。
这件事情是他跟我说的。	搿桩事体伊告我讲个。
这件事至关重要。	搿桩事体至关重要。
这份报纸是免费的。	搿份报纸是免费个。
这位女士是不是推销员？	搿位女士是推销员𠲎？
这儿周围有没有小菜场跟大型超市，买生活用品方便吗？	搿搭周围有勿有小菜场跟大型超市，生活用品买起来方便𠲎？
这儿烫发有游离子烫、负离子烫、直板烫、钢丝烫、玉米须烫。	搿搭烫发有游离子烫、负离子烫、直板烫、钢丝烫、玉米须烫。
这儿的衬衫没那儿的平整质量好。	搿搭个衬衫呒没伊面个挺刮。
这儿要换地铁和轻轨方便吗？	搿搭要调地铁咾轻轨便当𠲎？
这只是偶发事件。	搿只勿过是难般发生个事体。
这只是突发奇想。	搿只勿过是突发奇想。
这只梨闻上去很香。	搿只生梨闻上去老香个。
这只鸭子不怎么烂。	搿只鸭子勿大酥。
这周放什么电影？	搿个礼拜放啥个电影？
这场秀棒极了，但是门票太贵了。	搿场秀嗲了一塌糊涂，但是门票忒贵了。
这场革命已经带来了很多改变。	搿场革命已经带来了交关改变。
这套书共四十八册。	搿套书共四十八册。
这孩子能数到20。	搿小人能数到20。
这家店从9点开到18点。	搿家店从9点钟开到18点。
这封信寄错地方了。	搿封信寄错脱地方了。
这年记高不成低不就，很痛苦。	搿年记高勿成低勿就，老痛苦个。
这并不是因为我恨他，相反我爱他。	搿勿是因为我恨伊，相反我爱伊。
这张CD是我的。	搿张CD是我个。
这张椅子需要修理。	搿张矮凳需要修理。
这房子在附近，两室一厅，装修也不错，一个月1500。	搿幢房子拉垃附近。两房一厅，装修也勿错个。收1500一个月。
这是DVD。	搿个是DVD。
这是一个例外。	搿是一个例外。
这是一会儿事。	搿是一会事体。
这是不是开到北京去的火车？	搿个阿是开到北京去个火车？
这是个高乃依式的选择。	搿是个高乃依式个选择。
这是什么东西？	搿个是啥物事？
这是你的DVD？	搿个是侬个DVD？
这是你的信。	搿是侬个信。
这是你的家人吗？	搿是侬个屋里向人𠲎？
这是去牛津大学的车吗？	搿是去牛津大学个车子𠲎？
这是史密斯先生。	搿个是史密斯先生。
这是季风季节。	搿是季风季节。
这是张木桌。	搿只是木头台子。
这是我们的荣幸。	搿是阿拉个荣幸。
这是我所见过的最大型的构造了。	搿是我见过个最大型个构造了。
这是我见过最美的景色了。	搿是我见过个最漂亮个景色了。
这是找零。	搿是找下来个钞票。
这是湖的最深处。	搿是湖最深个地方。
这是简体字。	搿个是简写。
这是繁体字。	搿个是老式写法。
这是自动投币电话，用一元硬币来打的。	搿只是自动投币电话，用一元硬币来打个。
这是重要的活动。	搿是重要个活动。
这本书值得再看一遍。	搿本书值得再看一遍。
这本书对你来说读起来太难了。	搿本书对侬来讲读起来太难了。
这本书我能借多久？	搿本书我好借多长辰光？
这本书要4美元。	搿本书要4块美元。
这本课本很好。	搿本课本老好个。
这条弄堂一直走走到底。	搿条弄堂笔直跑跑到底。
这条河比那条长三倍。	搿条河浜比哀条长三倍。
这条狗杂交。	搿只狗杂交。
这条连衣裙很便宜。	搿条连衣裙老便宜个。
这条领带颜色亮一点，跟这件西装比较配。	搿条领带颜色跳一点，跟搿件西装比较配。
这样烂的菜还要这么贵啊！	搿能介烂糟糟个菜要介贵啊！
这根湿掉的火柴点不出火的。	搿根潮脱个火柴点勿出火个。
这次一进医院，才知道身体健康最最重要。	搿趟一进医院，再晓得身体健康最最要紧。
这次洪水泛滥渔民倒霉。	搿趟洪水泛滥渔民倒霉。
这点药一天吃三次。	搿眼药一天吃三次。
这点铝锅都可以扔掉了，因为我把新的厨房炊具都买好了。	搿眼钢种锅子侪好掼脱伊唻，因为我新个厨房炊具侪买好了咾。
这班火车几点钟开？	火车搿班几点钟开？
这男人和他妻子互相帮助。	搿男人跟伊拉老婆互相帮助。
这种款式的帽子现在很流行。	搿种款式个帽子现在老流行个。
这种秘密总有一天会被揭露的。	搿种秘密总有一天会被揭露个。
这种颜色比那种稍微深一点。	搿只颜色比伊只稍为深一眼。
这箱子是空的，里面什么也没有。	搿箱子是空个，里向啥也呒没。
这辆双排气管的跑车的发动机功率好大吧！	搿部双排气管跑车个马达结棍唻！
这辆车卖得好。	个车卖来好。
这辆车去静安寺吗？	搿部车子到静安寺去𠲎？
这辆车是区间车，到梅陇新村要回驶。	搿部是区间车，到梅陇新村要调头。
这辆迷你巴士能容纳25个人。	搿部迷你巴士好坐25个人。
这部电影为她赢得了人气。	搿部电影为伊赢得了人气。
这里允许拍照吗？	搿搭允许拍照𠲎？
这里小区的绿地面积有多少？	搿搭小区绿地面积有多少？
这里的“南翔小笼”没治了！	搿搭个“南翔小笼”顶脱唻！
这问题正在被讨论。	搿个问题正垃海被讨论。
这阵天气很冷，常常到零下二三度。	搿枪天气老冷个，常常到零下二三度。
这音乐值得听许多次。	搿音乐值得听交关趟。
进来之前请敲门。	进来之前请敲门。
遭受心脏病困扰的人数增加了。	受心脏病困扰个人数增加了。
那不是猫。那是狗。	哀个勿是猫。哀个是狗。
那个发现纯属偶然。	哀个发现纯粹是偶然。
那个男人戴着一个老虎的面具。	哀个男人戴了个老虎面具。
那个穿棕色大衣的女人是谁？	哀个穿棕色大衣个女人是啥人？
那么你下午到过几个地方？	葛末侬下半天到过几个地方？
那么你频道换掉也行啊。	葛末侬频道隔脱伊好唻。
那么再加我两只！	葛末再加我两只！
那么我来送你。	葛末我来送送侬。
那么我等着，你马上来吧！再见！	葛末我等垃海，侬马上来噢！再会！
那些不是你们的书？	哀面一眼勿是㑚个书？
那位女的是吃烤夫长大的。	哀个女个吃烤夫长大个。
那儿的书是他们的。	哀面个书是伊拉个。
那家店里的新货全卖光了。	唉爿店地里向个新货侪扫光了。
那张CD是我儿子的。	哀张CD是阿拉儿子个。
那当然是这里的面筋百叶双档最最地道。	葛是搿搭个面筋百叶双档最最正宗。
那条船昨天穿过了赤道。	哀条船昨日穿过了赤道。
那条黄瓜多长啊！	哀条黄瓜多少长啊！
那栋灰色的大楼吗？	哀栋灰颜色个大楼吗？
那路当然挺远的，我们打的去算了。	葛是路蛮远个，阿拉叫差头去算了。
部落成员沿着河岸定居了。	部落成员沿牢河边定居了。
里面开了一个个欧式的小店，情调好极了！	里向开了一爿爿欧式小店，情调瞎嗲！
钟还没响。	钟还呒没响。
钱是他想要的最后的东西。	钞票是伊想要个末脚一样物事。
铃响了。	铃响了。
银行在哪里？	银行垃海阿里搭？
银行对风险客户收取较高的贷款利息。	银行对风险客户收取较高个贷款利息。
长年累月东奔西走忙死了，生活太没有规律了。	长年累月投东投西忙煞，生活忒呒没规律了。
门一开，他们就逃走了。	门一开，伊拉就逃了跑了。
门口有个人。	门口头有个人。
“门槛精到九十六”、“额角头碰着天花板”、“霉头触到哈尔滨”，讲话还用意识流。	“门槛精到九十六”、“额角头碰着天花板”、“霉头触到哈尔滨”，讲言话还用意识流。
问题是我们如何应付目前的困难。	问题是阿拉哪能应付目前个困难。
闹市中心辟出新的天地来，闹中取静，又创新又怀旧。	闹市中心辟出新个天地，闹中取静，又创新咾又怀旧。
闹起新房来，可想而知要热闹得不得了！	闹起新房来，可想而知要闹猛得一塌糊涂了！
阿姨，今天竹笋特新鲜，称几斤去怎么样？	阿姨，今朝竹笋老嫩个，称两斤去哪能？
阿姨，您别客气，喝杯开水就行。	阿姨勿要客气，倒杯白开水吃吃好了。
除了亲戚，还请来了上司、同事、大学中学小学的同学等等。	除脱亲眷，还请来了上司、同事、大学中学小学个同学咾啥。
除了洋葱我什么都可以吃。	除脱洋葱我啥侪可以吃。
除了真相，我什么都不说。	除脱真相，我啥都勿讲。
除了雨天，我都是骑车去上班的。	除脱雨天，我侪是踏脚踏车去上班个。
除非雨停了，我们才会出去。	除非雨停了，阿拉才会得出去。
随便怎么走，怎么快就怎么开！	随便哪能走，哪能快就哪能开！
难怪她表示不想再见到他了。因为他们分手了。	怪勿得伊表示勿想再见到伊了。因为伊拉分手了。
难道他可以买一把刀，而我就不行了？	难道伊可以买把刀，但我就勿来自了？
雨不停，我们不会出去。	雨勿停，阿拉勿会出去。
面对巨大的困难，他成功了。	面对巨大个困难，伊成功了。
音乐是人类共通的语言。	音乐是人类共通个语言。
顾客没来。	顾客呒没来。
风刮得太猛，他们没法在公园里玩了。	风刮了忒结棍，伊拉呒没办法垃海公园里白相了。
风马牛不相及。	冬瓜传垃茄门里。
飞行愉快！	飞行愉快！
饭勿要盛得满得很。	饭勿要盛了拍拍满。
马屁拍在马脚上。	马屁拍勒马脚浪。
马路斜对面有一家便利店。	马路斜对过有一家便利店。
马路滑的。	马路滑个。
马马虎虎，侪都属中上等。	马马虎虎，侪属于中上等。
鲍勃第一个到达终点线。	鲍勃第一个到达终点线。
鸟儿筑巢。	鸟造巢个。
黄浦江两岸最好看，可以坐在船里游览。	黄浦江两岸最好看，可以坐拉船里游览。
